a	工
a	戈
aa	式
aa	藏
aaa	工
aaaa	工
aad	匿
aadk	匿
aadn	慝
aah	芽
aaht	芽
aak	戒
aan	苣
aanf	苣
aat	荛
aatq	荛
aau	藏
aauh	藏
aay	式
aayi	式
ab	节
ab	萨
abe	荫
abef	荫
abf	茸
abh	邛
abi	蒸
abib	菡
abio	蒸
abiu	荪
abj	节
abm	茁
abmj	茁
abn	芤
abnb	芤
abr	艿
abry	菰
abu	萨
abut	萨
aby	芨
abyu	芨
ac	芭
ac	茅
aca	茎
acaf	茎
acb	芭
ack	苔
ackf	苔
acn	茅
acnm	蓣
acnt	茅
ad	苦
ad	惹
ada	莽
adaj	莽
adaw	蕻
adb	苊
adbb	苊
adc	茇
adcy	茇
ade	戎
adef	葫
ader	苈
adf	蓐
adf	苦
adff	蓐
adfi	萘
adg	葳
adgv	葳
adh	荐
adhb	荐
adhd	葜
adhf	茬
adhg	苤
adk	若
adkf	若
adkn	惹
adm	项
admu	蒇
admy	项
adu	茂
aduw	蕨
adw	萁
adwn	葚
adwt	蓁
adwu	萁
adx	茏
adxy	茏
ae	功
ae	苏
aeb	莩
aebc	菔
aebf	莩
aee	荔
aeee	荔
aeej	蒯
aeg	苴
aegf	苴
aek	茄
aekf	茄
aer	藐
aerq	藐
aes	菜
aesu	菜
aet	散
aet	功
aety	散
aeu	藤
aeui	藤
aev	荽
aevf	荽
aew	苏
aewu	萸
aewu	苏
af	革
af	鞋
afa	鞯
afab	鞯
afae	鞴
afaf	鞲
afc	靶
afcn	靶
afcs	鞣
afcu	芸
afcu	芰
afd	鞑
afdj	薷
afdp	鞑
afe	勒
afet	勒
aff	苷
aff	芏
afff	鞋
afff	葑
afi	蒜
afie	鞘
afii	蒜
afj	靼
afj	革
afjg	靼
afk	薹
afkf	薹
afl	蕾
aflf	蕾
afm	贰
afmd	鞅
afmy	贰
afn	苇
afnh	苇
afp	鞍
afpb	荸
afpv	鞍
afq	芜
afqb	芫
afqb	芜
afqo	鞠
afqq	鞔
afqw	莰
afqy	鞫
afr	靳
afrh	靳
afs	藉
afsj	藉
afsy	藕
aft	著
aftj	鞒
aftj	蓍
aftj	著
afu	蔷
afuk	蔷
afw	鞭
afwr	鞭
afwt	菱
afwx	靴
afwy	藿
afy	甙
afyi	甙
ag	七
ag	巧
aga	荆
agaj	荆
agd	匡
age	菁
agef	菁
ageg	蕤
agf	芋
agfj	芋
agh	蔫
aghg	廿
aghh	艹
agho	蔫
agj	蕙
agjn	蕙
agm	芾
agmh	芾
agmm	颟
agn	匚
agn	七
agnn	巧
agny	戈
agq	葬
agqa	葬
agqg	薤
ags	茉
agsu	茉
agt	廾
agth	廾
agu	芙
agud	荚
aguf	苹
agus	莱
agv	萋
agvv	萋
agx	荑
agxw	荑
ah	牙
ah	雅
ahd	菲
ahdd	匪
ahdd	菲
ahf	芷
ahf	苜
ahg	蘧
ahgp	蘧
ahi	菽
ahic	菽
ahk	颐
ahkf	苫
ahkm	赜
ahkm	颐
ahko	熙
ahn	臣
ahnh	卧
ahnh	臣
aht	雅
ahtb	邪
ahte	牙
ahtg	鸦
ahtp	迓
ahty	雅
ahx	茈
ahxb	茈
ai	东
ai	落
aia	茳
aiaf	茳
aias	蕖
aib	范
aibb	范
aibu	菠
aie	菹
aieg	菹
aig	萍
aigf	萍
aii	莎
aii	东
aiit	莎
aik	藻
aiks	藻
ain	荡
ainr	荡
aiq	鸫
aiqg	鸫
air	蒎
aire	蒎
ais	蒲
aisf	薄
aisk	菏
aisu	蒲
ait	蔽
aitk	落
aitl	藩
aitu	蔽
aiu	汞
aiy	茫
aiyn	茫
aiyv	蒗
aj	划
aj	草
ajb	蕞
ajbc	蕞
ajd	莫
ajde	募
ajdf	墓
ajdg	蓦
ajdh	幕
ajdj	暮
ajdn	慕
ajdr	摹
ajdu	莫
aje	萌
ajef	萌
ajf	昔
ajfu	莳
ajh	划
ajj	草
ajjf	菖
ajl	蔓
ajlc	蔓
ajq	葛
ajqg	鹊
ajqn	葛
ajt	蓝
ajtl	蓝
aju	茧
ajv	郾
ajvb	郾
ak	或
ak	惑
akb	葺
akbf	葺
akby	蕺
akd	叵
akg	勤
akgb	鄞
akgd	或
akge	勤
akgf	堇
akgn	惑
akgq	觐
akh	匮
akhm	蒉
akhm	匮
akk	颧
akkf	莒
akkg	鹳
akkm	颧
akkn	萼
akm	莴
akmw	莴
aku	燕
akuo	燕
al	苗
al	莲
ala	蔑
alaw	蔑
ald	茵
aldn	蒽
aldu	茵
alf	薯
alf	苗
alfj	薯
alk	匣
alkf	茴
aln	葸
alnu	葸
alp	莲
alph	瞢
alpu	莲
alpx	薨
alpy	甍
alq	萝
alqg	鹋
alqu	萝
alt	菌
altu	菌
alv	匦
alvv	匦
am	贡
am	黄
amd	英
amdu	英
amf	苒
amff	苒
amfp	遘
amfq	觏
amg	茼
amgk	茼
amh	匝
amhk	萜
amhk	匝
amk	苘
amkf	苘
amq	苋
amqb	苋
amu	贡
amw	黄
amwu	芮
amwu	黄
an	艺
an	世
ana	苠
anab	苠
anb	芑
anb	艺
and	巨
anf	蔚
anff	蔚
anh	蔬
anhc	葭
anhk	蔬
ank	薜
anku	薜
anm	贳
anmu	贳
ann	蕊
annn	蕊
anu	芯
anud	荬
anv	世
anw	蓼
anwe	蓼
any	忒
anyi	忒
anyu	荩
anyw	苡
ao	蘑
ao	蘼
aoa	蔗
aoao	蔗
aos	蘼
aosd	蘑
aosd	蘼
aov	蒌
aovf	蒌
aovt	薮
ap	芝
ap	蒙
apd	菪
apdf	菪
ape	劳
aper	劳
apf	蒙
apfc	蔻
apfe	蒙
apff	茔
apfq	莞
apg	莹
apgf	苎
apgg	萱
apgy	莹
api	荥
apiu	荥
apj	萤
apju	萤
apk	营
apkk	营
apl	荤
aplj	荤
apn	菅
apnf	茕
apnf	菅
apo	荧
apou	荧
apq	莺
apqb	菀
apqf	蓥
apqg	莺
aps	荣
apsu	荣
apt	荦
aptg	荦
apu	芝
apw	蓉
apwj	蓿
apwk	蓉
apx	萦
apxi	萦
aq	匹
aq	敬
aqa	芪
aqab	芪
aqb	苑
aqbb	苑
aqe	萏
aqef	萏
aqg	蓟
aqgb	茚
aqgf	茑
aqgj	蓟
aqgu	藓
aqj	荀
aqjf	荀
aqk	警
aqkf	苟
aqkf	茗
aqkr	擎
aqks	檠
aqkt	敬
aqky	菟
aqky	警
aqn	苞
aqnb	苞
aqo	菊
aqou	菊
aqr	葱
aqrn	葱
aqrr	芴
aqs	葡
aqsu	葡
aqt	萄
aqtb	茆
aqtb	萄
aqtd	获
aqto	荻
aqty	莸
aqv	匹
aqw	芡
aqwu	芡
aqy	芍
aqyu	芍
ar	区
ar	艾
arc	葩
arcb	葩
ard	菝
ardy	菝
arg	瓯
argy	瓯
ari	区
arj	芹
ark	匠
arq	欧
arqg	鸥
arqq	蔸
arqw	欧
art	萆
artf	萆
aru	艾
arw	殴
arwc	殴
as	莆
as	茜
asf	茜
asg	苯
asgf	苯
asgo	蘸
ash	葙
ashf	葙
asj	蕈
asjj	蕈
ask	苛
askf	苛
askw	蔌
asr	菥
asrj	菥
asu	莆
asw	菘
aswc	菘
at	攻
at	董
ata	苌
atay	苌
atb	莠
atbr	莠
atd	医
atdi	医
atdj	荞
atdn	翳
atdp	蓬
atf	芊
atfj	芊
atfp	莛
atfu	茱
atg	董
atgf	董
atgn	翘
atgo	薰
atgq	尧
atgs	荇
ath	蓰
athh	蓰
atj	莉
atjj	莉
atl	蓖
atlx	蓖
atm	薇
atmt	薇
atn	薛
atnb	孽
atns	蘖
atnu	薛
ato	蕃
atol	蕃
atq	蘅
atqi	藜
atqs	蘅
atr	莪
atry	莪
atv	萎
atvf	萎
atx	莓
atxi	蘩
atxu	莓
aty	攻
au	蒋
au	臧
aua	臧
auah	臧
aub	蒴
aube	蒴
auj	莘
aujn	薏
aujr	蕲
auk	菩
aukf	菩
auq	茨
auqf	蒋
auqw	茨
aur	茭
auru	茭
aus	薪
ausr	薪
aut	蒺
autd	蒺
auv	蒹
auvw	蒹
auw	蔺
auwy	蔺
av	切
av	萧
avb	艽
avd	菇
avdf	薅
avdf	菇
avf	荨
avfu	荨
avh	萧
avhw	萧
avk	茹
avkf	苕
avkf	茹
avt	切
avu	茛
avy	芄
avyu	芄
aw	共
aw	花
awb	苍
awbb	苍
awc	蓊
awcn	蓊
awcu	芟
awd	茯
awdu	茯
awf	蔡
awfc	荟
awff	茌
awfi	蔡
awfu	苻
awg	葵
awgd	葵
awgf	荃
awgg	莶
awgs	荼
awgt	蔹
awh	莜
awht	莜
awi	戍
awj	芥
awjj	芥
awk	葆
awks	葆
awn	巷
awnb	巷
awnu	恭
aws	茶
awsk	荷
awsu	茶
awt	荏
awtf	荏
awu	莅
awu	共
awuf	莅
awuk	蓓
awv	芬
awvr	芬
aww	巫
awwi	巫
awwq	觋
awwu	苁
awx	花
awxb	花
awy	恐
awyc	苓
awyf	萑
awyh	跫
awyj	蛩
awyj	劐
awyn	芩
awyn	恐
awyo	蕉
awyq	銎
awyy	巩
ax	药
ax	蕴
axa	荭
axaf	荭
axb	芎
axf	荮
axfu	荮
axg	莼
axgn	莼
axj	蕴
axjl	蕴
axq	药
axqy	药
axt	芗
axtr	芗
axx	芘
axxb	芘
axxf	荜
axxr	蒈
ay	芳
ay	荒
ayc	茺
aycq	茺
ayh	苄
ayhu	苄
ayi	弋
ayj	蔼
ayjj	荠
ayjn	蔼
ayk	蓑
ayke	蓑
aym	蒿
aymk	蒿
ayms	藁
ayn	芦
ayna	匾
aynb	芒
aynk	荒
aynr	芦
ayp	葶
ayps	葶
ayq	鸢
ayqg	鸢
ayr	蓠
ayr	芳
ayrc	蓠
ayt	蔟
aytd	蔟
ayu	蒂
ayuh	蒂
ayuy	蒡
ayv	莨
ayvu	莨
ayw	萃
aywf	萃
aywu	菸
ayx	蓄
ayxl	蓄
ayxy	蕹
b	了
b	子
ba	陈
bai	陈
baiy	陈
bb	子
bb	孕
bbb	子
bbbb	子
bbc	陬
bbcy	陬
bbf	孕
bbh	耶
bby	陂
bc	取
bc	聚
bca	陉
bcag	陉
bcc	聂
bccm	颞
bccu	聂
bci	聚
bcib	鄹
bciu	聚
bcl	盈
bcla	戤
bclf	盈
bcv	娶
bcvf	娶
bcy	取
bd	承
bd	随
bda	隋
bdae	隋
bdan	隳
bde	随
bdef	堕
bdep	随
bdi	承
bdii	承
bdj	陌
bdjg	陌
bdm	颇
bdmy	颇
bdx	陇
bdxy	陇
be	阴
be	阻
beg	阻
beg	阴
begg	阻
bf	际
bf	陵
bfd	孺
bfdj	孺
bfh	陡
bfhy	陡
bfi	际
bfiy	际
bfj	阱
bfjh	阱
bfq	阮
bfqn	阮
bfw	陵
bfwt	陵
bg	卫
bg	陆
bgb	陆
bgbh	陆
bgd	卫
bgh	耳
bghg	耳
bgk	隔
bgkh	隔
bgm	陋
bgmn	陋
bgq	阢
bgqn	阢
bgu	陕
bgud	陕
bh	耻
bh	蚩
bhg	蚩
bhg	耻
bhgj	蚩
bhh	陟
bhhg	骘
bhht	陟
bhk	屮
bhkg	阽
bhn	鼐
bhnn	鼐
bi	孙
bi	函
bib	函
bibk	函
big	丞
bigb	卺
bigf	丞
bij	隙
biji	隙
bip	逊
bipi	逊
biu	尕
biy	孙
bj	阳
bj	隅
bjf	陧
bjfg	陧
bjg	阳
bjm	隅
bjmy	隅
bjx	隰
bjxo	隰
bk	职
bk	亟
bkc	亟
bkcg	亟
bkh	聩
bkhm	聩
bkm	陨
bkmy	陨
bkw	职
bkwy	职
bl	阵
bl	孟
ble	勐
blet	勐
blf	孟
blg	隈
blge	隈
blh	阵
bm	出
bm	聘
bmf	祟
bmfg	聃
bmfi	祟
bmg	聘
bmgn	聘
bmk	出
bmo	粜
bmou	粜
bn	也
bn	皮
bnh	阝
bnh	凵
bnh	卩
bnh	了
bnhg	孑
bnhn	也
bnn	孔
bnt	乃
bnty	皮
bo	耿
boy	耿
bp	辽
bp	院
bpf	院
bpfq	院
bpk	辽
bpq	耽
bpqn	耽
bps	聍
bpsh	聍
bpx	陀
bpxn	陀
bq	陶
bq	聊
bqe	陷
bqeg	陷
bqn	孢
bqnn	孢
bqt	聊
bqtb	陶
bqtb	聊
bqv	隐
bqvn	隐
br	孤
br	阪
brc	阪
brcy	孤
brcy	阪
brg	隍
brgg	隍
brq	隗
brqc	隗
brt	陴
brtf	陴
bs	阿
bs	耵
bsh	耵
bsk	阿
bskg	阿
bt	降
bt	隆
btd	聒
btdg	聒
btf	阡
btfa	陲
btfh	阡
btg	隆
btgg	隆
btgh	降
bth	阼
bthf	阼
bty	孜
bu	联
bu	陪
bud	联
budy	联
bue	隧
buep	隧
buj	障
bujh	障
buk	陪
bukg	陪
bukn	聪
buw	隘
buwl	隘
bv	限
bvy	限
bw	队
bw	险
bwf	附
bwff	坠
bwfy	附
bwg	除
bwgg	险
bwgs	除
bwj	阶
bwjh	阶
bwy	聆
bwy	队
bwyc	聆
bx	陛
bxx	陛
bxxf	陛
by	及
by	防
byi	孓
byi	及
byn	孩
bynw	陔
bynw	孩
byt	防
c	以
c	又
ca	戏
ca	劲
cad	颈
cadm	颈
cae	劲
caet	劲
caj	弁
cajh	刭
cap	迳
capd	迳
cay	巯
cay	戏
cayk	巯
cb	邓
cbh	邓
cc	双
cc	叠
ccc	又
cccc	又
cccf	垒
cccg	叠
cccm	颡
cccs	桑
ccy	双
cd	参
cd	叁
cdd	叁
cddf	叁
cde	毵
cdee	毵
cder	参
cdg	牯
cdl	畚
cdlf	畚
cds	犄
cdsk	犄
ce	能
ce	劝
cee	勇
ceer	勇
cej	甬
cen	牦
cenu	恿
cep	通
cepk	通
cet	劝
cex	熊
cexo	熊
cexx	能
cf	对
cf	特
cff	圣
cffy	特
cfg	牡
cfn	犊
cfnd	犊
cfnu	怼
cfy	对
cg	马
cg	骗
cga	驱
cgaq	骁
cgar	驱
cgb	骤
cgbi	骤
cgbn	驰
cgc	驭
cgce	骖
cgcg	驿
cgcj	骚
cgck	骀
cgct	骏
cgcy	驭
cgd	骑
cgd	马
cgdk	骑
cgdw	骐
cgdy	驮
cge	驵
cgeg	驵
cgg	骊
cggy	骊
cgj	骒
cgjs	骒
cgk	驯
cgkg	牾
cgkh	驯
cgkr	驶
cgl	骡
cglg	驷
cgli	骡
cgm	骋
cgmn	骋
cgn	骣
cgnb	骣
cgp	驼
cgpx	驼
cgq	驹
cgqk	驹
cgql	骝
cgqv	驺
cgr	驳
cgrr	驳
cgs	骠
cgsi	骠
cgt	骄
cgtj	骄
cgtk	骆
cgtn	骢
cgu	骥
cgua	骈
cguw	骥
cgw	验
cgwf	驸
cgwf	骅
cgwg	验
cgwy	骓
cgy	驴
cgya	骗
cgye	骧
cgyg	驻
cgyn	骟
cgyn	驴
cgyw	骇
ch	犋
chwy	犋
ck	台
ck	怠
ckb	邰
ckbh	邰
ckf	台
ckn	怠
cknu	怠
cko	炱
ckou	炱
ckp	迨
ckpd	迨
cm	观
cmq	观
cmqn	观
cn	予
cn	预
cnh	巴
cnhe	豫
cnhg	骛
cnhg	鹜
cnhg	鹬
cnhh	瞀
cnhj	蟊
cnhj	蝥
cnhj	予
cnhm	预
cnhn	矜
cnhn	巴
cnhq	鍪
cnhs	柔
cnht	矛
cnhv	婺
cny	厶
cq	物
cq	欢
cqb	允
cqg	鸡
cqgg	鸡
cqr	物
cqrt	物
cqw	欢
cqwy	欢
cs	牺
csg	牺
ct	矣
ct	牧
ctd	矣
ctdu	矣
ctf	牿
ctfk	牿
ctg	牲
ctgg	牲
ctgj	牟
cty	牧
cv	艰
cv	犍
cvg	犍
cvgp	犍
cvy	艰
cw	难
cw	皴
cwt	逡
cwtb	皴
cwtp	逡
cwy	难
cwyg	难
cx	牝
cxn	牝
cy	叉
cy	蚤
cyi	叉
cyj	蚤
cyju	蚤
cym	犒
cymk	犒
cyn	犏
cyna	犏
d	在
d	大
da	左
da	砸
daf	左
dah	砑
daht	砑
dai	礴
daif	礴
daj	厝
dajd	厝
dam	砸
damh	砸
damw	磺
dan	碟
dans	碟
dap	礞
dape	礞
dar	奁
daru	奁
dary	砹
dat	硗
datq	硗
dav	砌
davt	砌
daw	礤
dawi	礤
day	硭
dayn	硭
db	破
db	顾
dbd	顾
dbdm	顾
dbf	耷
dbm	础
dbmh	础
dbv	厄
dby	破
dc	友
dc	雄
dcc	磉
dccs	磉
dcd	碜
dcde	碜
dcg	码
dcgg	码
dcu	友
dcw	雄
dcwy	雄
dd	大
dd	套
ddd	磊
dddd	大
dddf	靥
dddf	磊
dddr	飙
ddg	碱
ddgk	碱
ddgq	砺
ddh	厦
ddht	厦
ddi	厌
ddl	厣
ddlk	厣
ddm	硕
ddmy	硕
ddr	魇
ddrc	魇
ddu	套
ddw	厮
ddwr	厮
ddwv	餍
de	历
de	胡
deb	郁
debh	郁
dee	髦
dee	历
deeb	髦
deeg	硼
def	髻
def	有
defk	髻
deg	胡
degq	髡
deh	髭
dehx	髭
del	鬟
dele	鬟
dem	髯
demf	髯
dep	鬃
depi	鬃
depw	鬓
deq	鹕
deqg	鹕
der	夯
det	髟
deto	鬏
deu	鬈
deub	鬈
dev	鬣
devk	髫
devn	鬣
dew	髹
dews	髹
df	夺
df	压
dfa	奔
dfaj	奔
dfc	磕
dfcl	磕
dfcy	砝
dfe	辰
dfef	辱
dfei	辰
dfej	蜃
dfek	唇
dff	奎
dfff	奎
dffg	硅
dfh	矸
dfi	奈
dfiu	奈
dfn	砖
dfnb	夸
dfnj	刳
dfnn	匏
dfny	瓠
dfny	砖
dft	奢
dftj	奢
dfu	夺
dfy	压
dfyi	压
dg	三
dg	感
dga	研
dgah	研
dgaj	硎
dgb	砘
dgbn	砘
dgd	戌
dggg	三
dgh	古
dghg	古
dgj	硬
dgjr	硬
dgk	咸
dgkd	咸
dgkf	厨
dgkn	感
dgl	礓
dglg	礓
dgm	碛
dgmy	碛
dgq	厉
dgqe	励
dgqe	厉
dgt	厂
dgtg	石
dgty	犬
dgty	戊
dgu	砰
dgud	硖
dguf	砰
dgv	威
dgvd	威
dgx	碡
dgxy	碡
dh	还
dh	否
dha	戛
dhau	戛
dhb	存
dhbd	存
dhd	慧
dhdf	砉
dhdn	慧
dhdv	彗
dhe	甭
dhej	甭
dhf	在
dhfd	在
dhg	歪
dhgb	邳
dhgd	丕
dhgh	歪
dhi	戚
dhi	不
dhih	蹙
dhii	戚
dhk	丰
dhkf	否
dhkg	砧
dhp	还
dhpi	还
dhq	艳
dhqc	艳
dht	夏
dhtu	夏
dhv	契
dhvb	孬
dhvd	契
dhvn	恝
dhvr	挈
di	砂
di	泵
dia	磲
dias	磲
die	硝
dieg	硝
dit	砂
ditt	砂
diu	泵
dj	百
dj	厚
djb	厚
djbd	厚
djf	厘
djf	百
djfd	厘
djg	碍
djgf	碍
djh	砷
djhh	砷
djn	奄
djnb	奄
djng	鹌
djq	碣
djqn	碣
dk	右
dk	夼
dkf	右
dkj	夼
dl	面
dl	奋
dlf	奋
dlh	砗
dlj	面
dljf	面
dlk	厍
dm	而
dm	耐
dma	碘
dmaw	碘
dmd	碳
dmdo	碳
dmf	碉
dmfk	碉
dmg	硐
dmgk	硐
dmh	布
dmhj	布
dmj	厕
dmjf	耐
dmjg	鸸
dmjj	而
dmjk	厕
dmjn	恧
dmjv	耍
dmq	砚
dmqn	砚
dmu	页
dn	成
dn	尤
dna	碾
dnae	碾
dnh	嘏
dnhc	嘏
dnj	尴
dnjl	尴
dnl	盛
dnlf	盛
dnq	尥
dnqy	尥
dnr	砀
dnrt	砀
dnv	尢
dnv	成
dnw	尬
dnwj	尬
dny	尤
dnyi	尤
do	矿
do	灰
dol	盔
dolf	盔
doq	磷
doqg	磷
dot	矿
dou	灰
dp	达
dp	牵
dpg	碇
dpgg	碹
dpgh	碇
dpi	达
dpq	碗
dpqb	碗
dpt	牵
dptg	牵
dpx	砣
dpxn	砣
dq	克
dq	确
dqa	砥
dqay	砥
dqb	克
dqd	兢
dqdq	兢
dqe	确
dqeh	确
dqg	鸪
dqgg	鸪
dqgs	磔
dqw	砍
dqwy	砍
dqy	矽
dr	原
dr	愿
drh	斫
dri	愿
drii	原
drin	愿
drr	爽
drrr	爽
drt	碑
drtf	碑
ds	厅
ds	奇
dsg	硒
dsh	厢
dshd	厢
dsj	碴
dsjg	碴
dsk	奇
dsk	厅
dskf	奇
dskj	剞
dskw	欹
dt	故
dt	帮
dtb	邦
dtbh	帮
dtbh	邦
dtf	寿
dtfo	焘
dtfu	寿
dth	砟
dthf	砟
dtk	硌
dtkg	硌
dtl	硇
dtlr	硇
dtn	砾
dtni	砾
dtp	砭
dtpy	砭
dtr	硪
dtry	硪
dty	故
du	辜
du	碰
dua	磋
duag	磋
dub	厥
dubj	劂
dubw	厥
duc	磙
duce	磙
dug	砬
duj	鹩
duj	辜
dujg	鹩
duk	碚
dukg	碚
duo	碰
duog	碰
dux	磁
duxx	磁
dv	肆
dv	碌
dva	厩
dvaq	厩
dvg	肆
dvgh	肆
dvi	碌
dviy	碌
dw	其
dw	期
dwa	砼
dwag	砼
dwe	期
dwef	舂
dweg	期
dwf	基
dwff	基
dwg	奉
dwgd	奏
dwgg	硷
dwgj	奉
dwgu	磴
dwi	仄
dwiu	泰
dwj	春
dwjf	春
dwjj	蠢
dwn	矶
dwna	戡
dwnb	甚
dwne	勘
dwnf	斟
dwq	欺
dwqw	欺
dwr	斯
dwrh	斯
dwry	砜
dwt	秦
dwtu	秦
dwu	其
dww	雁
dwwm	赝
dwwy	雁
dwx	綦
dwxi	綦
dwy	矾
dwyg	碓
dwyo	礁
dwyy	矾
dx	龙
dx	龚
dxj	砩
dxjh	砩
dxx	砒
dxxn	砒
dxy	袭
dxyb	聋
dxyd	砻
dxye	袭
dxyf	垄
dxyi	龙
dxyw	龚
dy	太
dy	态
dyb	礅
dybt	礅
dyc	硫
dyck	硫
dyi	丈
dyi	太
dyn	态
dyna	碥
dynu	态
dyu	磅
dyuh	碲
dyuy	磅
dyw	碎
dywf	碎
e	有
e	月
ea	肛
ea	毁
eaf	腻
eafy	腻
eag	肛
eai	胨
eaiy	胨
eaj	舁
eajd	膜
eajd	貘
eajg	腊
eap	朦
eape	朦
eaw	毁
eawc	毁
eb	服
eb	乳
ebb	郛
ebbh	郛
ebc	服
ebcy	服
ebf	孚
ebn	乳
ebnn	乳
ec	肥
ec	胎
eca	胫
ecag	胫
eck	胎
eckg	胎
ecn	肥
ect	毪
ectg	毪
ed	须
ed	胯
edc	肱
edcy	肱
edf	胯
edfn	胯
edh	胚
edhg	胚
edj	腌
edjg	貊
edjn	腌
edl	腼
edlf	腼
edm	须
edmy	须
edw	腠
edwd	腠
edx	胧
edxy	胧
edy	肽
edyy	肽
ee	朋
ee	鹏
eeb	脬
eebg	脬
eee	月
eeeb	毳
eeee	月
eeen	勰
eef	舀
eeg	朋
eeq	鹏
eeqg	鹏
eet	肋
eet	肜
eew	胁
eewy	腴
eewy	胁
ef	肚
ef	脚
efc	肢
efcb	脚
efcy	肢
efg	肚
efh	肝
efhw	虢
efj	肼
efjh	肼
efk	膨
efkc	臌
efke	膨
efm	腩
efmf	腩
efn	肟
efnn	肟
efp	脖
efpb	脖
efq	朊
efqn	朊
eft	豺
eftt	豺
efy	肘
eg	且
eg	助
egb	肫
egbn	肫
egc	县
egcn	悬
egcu	县
egd	爰
egd	且
egdc	爰
ege	助
egeg	腈
eget	助
egey	豚
egk	膈
egkh	膈
egm	肺
egmh	肺
egw	雎
egwy	雎
egx	胰
egxw	胰
egy	肤
eh	毡
eh	叟
ehc	叟
ehcu	叟
ehd	腓
ehdd	腓
ehh	胩
ehhy	胩
ehkd	毡
ehn	胪
ehnt	胪
ei	膛
ei	盥
eig	胱
eigq	胱
eil	盥
eilf	盥
eip	膛
eipf	膛
ej	胆
ej	腥
ejg	胆
ejgg	胆
ejh	刖
ejhh	胂
ejl	腽
ejlg	腽
ejt	腥
ejtg	腥
ek	加
ek	架
ekc	驾
ekcg	驾
ekg	加
ekh	肿
ekhh	肿
ekk	臊
ekkn	腭
ekks	臊
ekm	贺
ekmu	贺
ekmw	脶
ekp	迦
ekpd	迦
eks	架
eksk	哿
eksu	架
eky	袈
ekye	袈
el	舆
el	爵
eld	胭
eldy	胭
ele	舅
eler	舅
elg	舆
elgw	舆
elh	胛
eln	腮
elny	腮
elv	爵
elvf	爵
em	觅
em	腆
ema	腆
emaw	腆
emg	胴
emgk	胴
emgo	爨
emgy	璺
emq	觅
emqb	觅
emw	肭
emwy	肭
en	力
en	鼠
eni	脲
eniy	脲
enr	肠
enrt	肠
ent	力
enu	鼠
enud	鼷
enuk	鼯
enum	鼬
enun	鼠
enuv	鼹
enuv	鼢
env	甩
eo	脏
eo	毯
eof	脏
eofg	脏
eoo	毯
eooi	毯
eoq	膦
eoqg	膦
eou	臁
eouw	臁
eow	腑
eowf	腑
eoy	脒
ep	边
ep	爱
epc	受
epcu	受
epd	爱
epdc	爱
epe	脓
epe	边
epey	脓
epf	脘
epfi	腙
epfq	脘
epg	腚
epgh	腚
epq	腕
epqb	腕
epqg	舜
epr	膑
eprw	膑
epv	胺
epvg	胺
epw	腔
epwa	腔
epwf	膣
eq	胸
eq	豹
eqa	胝
eqay	胝
eqd	脆
eqdb	脆
eqg	氇
eqgj	氇
eqk	朐
eqkg	朐
eqn	胞
eqnn	胞
eqo	舄
eqou	舄
eqr	胸
eqrb	胸
eqw	肷
eqwy	肷
eqy	豹
eqyy	豹
er	貌
er	脾
erc	胍
ercy	胍
eri	腺
eriy	腺
erq	邈
erqn	貌
erqp	邈
ers	脎
ersy	脎
ert	脾
ertf	脾
es	采
es	腰
ese	彩
eset	彩
esf	膊
esfi	膘
esfy	膊
esu	采
esv	腰
esvg	腰
esw	膝
eswi	膝
esy	脯
et	用
et	毛
eta	胀
etay	胀
etf	遥
etfg	鹞
etfi	繇
etfp	遥
etg	胜
etgg	胜
etgn	毛
eth	臼
ethf	胙
ethg	臼
etj	腹
etjt	腹
etk	胳
etkg	貉
etkg	胳
etl	貔
etlx	貔
etn	用
etnh	用
ett	彡
ettt	彡
ety	豸
etyt	豸
eu	胶
eu	腾
eua	胼
euah	胼
eud	朕
eudy	朕
eug	胖
eugf	塍
eugg	腾
eugh	胖
eugi	滕
eugv	媵
euj	臆
eujn	臆
euk	脱
eukq	脱
euo	氆
euoj	氆
eur	胶
eury	胶
euu	膳
euuk	膳
ev	妥
ev	腿
evf	妥
evg	腱
evgp	毽
evgp	腱
evk	貂
evkg	貂
evp	腿
evpy	腿
ew	办
ew	脸
ewc	股
ewcy	股
ewe	胗
ewet	胗
ewf	脍
ewfc	脍
ewg	脸
ewgg	脸
ewgj	腧
ewi	臾
ewi	办
ewn	肌
ews	貅
ewsy	貅
eww	脞
ewwf	脞
ex	脂
ex	奚
exd	奚
exdu	奚
exj	脂
exjg	脂
ey	肪
ey	脑
eyj	脐
eyjh	脐
eyl	膻
eylg	膻
eyn	脉
eyni	脉
eynw	胲
eyr	脑
eyrb	脑
eyt	肪
eyu	膀
eyuk	膪
eyuy	膀
eyw	肮
eywn	肮
eywy	腋
eyx	臃
eyxy	臃
f	地
f	土
fa	域
fa	戴
fae	霰
faet	霰
faf	霸
fafe	霸
faj	卉
fajv	堰
fak	哉
fakd	哉
fakg	域
fal	载
fald	载
falw	戴
fam	贲
famu	贲
fan	堞
fans	堞
fas	栽
fasi	栽
faw	塔
fawk	塔
fawy	截
fay	裁
faye	裁
fb	坡
fb	圾
fbh	邯
fbh	邗
fbn	地
fby	圾
fby	坡
fbyy	圾
fc	支
fc	云
fcb	却
fcbh	却
fce	动
fcet	劫
fcet	动
fcl	盍
fclf	盍
fcn	翅
fcnd	翅
fcp	运
fcpi	运
fcr	魂
fcrc	魂
fct	埃
fctd	埃
fcu	去
fcu	云
fcu	支
fd	城
fd	需
fde	雳
fder	雳
fdet	坜
fdf	震
fdfe	震
fdfn	垮
fdh	坏
fdhg	坯
fdhy	坏
fdj	埯
fdjn	埯
fdm	需
fdmj	需
fdmm	颥
fdmy	顸
fdn	城
fdnn	城
fdr	塬
fdri	塬
fdw	堪
fdwn	堪
fdx	垅
fdxy	垅
fe	协
fe	霓
fee	堋
feeg	堋
fef	埒
fefy	埒
fej	霾
fejf	霾
feq	霓
feqb	霓
few	协
fewy	协
ff	寺
ff	封
ffc	坛
ffcy	坛
fff	圭
ffff	土
fffy	封
ffg	坩
ffh	填
ffhg	埴
ffhw	填
ffhy	卦
ffi	款
ffiw	款
ffn	雩
ffnb	雩
ffnn	圬
ffnu	恚
fft	堵
fftj	堵
ffu	墙
ffu	寺
ffuk	墙
fg	十
fg	干
fgc	垤
fgcf	垤
fgf	圩
fgfh	圩
fgg	二
fggh	干
fggy	未
fgh	士
fgh	十
fghg	甘
fghg	士
fghy	雨
fghy	寸
fgj	垣
fgjg	垣
fgjr	埂
fgk	塥
fgkh	塥
fgo	垭
fgog	垭
fgu	坪
fguf	坪
fh	直
fh	起
fha	越
fhan	越
fhb	趣
fhbc	趣
fhd	霏
fhdd	霏
fhe	趄
fheg	趄
fhf	赶
fhf	直
fhfh	矗
fhfk	赶
fhg	址
fhgj	趔
fhh	赴
fhhi	赴
fhi	趟
fhik	趟
fhk	坫
fhkg	坫
fhl	盐
fhlf	盐
fhn	起
fhnh	赳
fhnt	垆
fhnv	起
fho	墟
fhog	墟
fhq	趋
fhqv	趋
fhr	赵
fhri	赵
fht	趱
fhtm	趱
fhu	走
fhuw	趑
fhv	超
fhvk	超
fhw	真
fhwe	趁
fhwm	颠
fhwu	真
fi	示
fi	霪
fie	霄
fief	霪
fief	霄
fig	霈
figh	霈
fiu	示
fiv	墚
fivs	墚
fj	刊
fj	韩
fja	戟
fjay	戟
fje	朝
fjeg	朝
fjf	埋
fjfg	埋
fjfh	韩
fjfy	埘
fjg	坦
fjgg	坦
fjgh	堤
fjh	坤
fjh	刊
fjhh	坤
fjj	亓
fjk	井
fjl	墁
fjlc	墁
fjn	塌
fjng	塌
fjp	进
fjpk	进
fjq	埸
fjqr	埸
fjt	乾
fjtn	乾
fjw	翰
fjwf	斡
fjwn	翰
fk	吉
fk	彭
fkd	颉
fkdm	颉
fke	袁
fkeu	袁
fkf	吉
fkg	埕
fkgg	埕
fkh	圳
fkhk	露
fkk	酃
fkkb	酃
fkm	埙
fkmw	埚
fkmy	埙
fku	喜
fkuc	鼓
fkue	彭
fkuf	鼙
fkuh	瞽
fkuk	嘉
fkuk	喜
fkuo	熹
fkuy	甏
fl	雷
fl	塄
flf	雷
fly	塄
flyt	塄
fm	南
fm	献
fmg	垌
fmgk	垌
fmn	垲
fmnn	垲
fmu	献
fmud	献
fmuf	南
fmy	坝
fmyg	坍
fn	志
fn	场
fnb	亏
fnbm	堀
fnh	韦
fnhc	霞
fnhe	韬
fnhk	韦
fnhl	韫
fnhp	违
fnhy	韧
fni	墀
fnig	墀
fnk	霹
fnku	霹
fnn	圯
fnn	圮
fnr	声
fnrt	场
fnu	卖
fnu	志
fnud	卖
fnuq	觌
fnw	块
fnwb	罄
fnwd	磬
fnwj	馨
fnwy	謦
fnwy	块
fnx	坭
fnxn	坭
fny	专
fnyi	专
fo	赤
fo	郝
fob	郝
fobc	赧
fobh	郝
fof	赫
fofj	赭
fofo	赫
fot	圹
fotj	螫
foty	赦
fou	赤
fov	塘
fovh	墉
fovk	塘
fp	过
fp	索
fpb	勃
fpbe	勃
fpbf	孛
fpbg	鹁
fpf	垸
fpfq	垸
fpg	壹
fpgc	彀
fpgc	觳
fpgn	懿
fpgu	壹
fpi	过
fpl	毂
fplc	毂
fpo	壶
fpof	壶
fpw	壳
fpwb	壳
fpwn	悫
fpx	索
fpxi	索
fpxn	坨
fq	无
fq	元
fqa	坻
fqay	坻
fqb	元
fqd	顽
fqdm	顽
fqk	鼋
fqkn	鼋
fqky	堍
fqn	雹
fqnb	雹
fqp	远
fqpv	远
fqu	均
fqug	均
fqv	无
fqw	坎
fqwy	坎
fr	垢
fr	坂
frc	坂
frcy	坂
frgk	垢
frh	圻
frt	埤
frtf	埤
fry	坼
fryy	坼
fs	某
fs	埔
fsa	耩
fsae	耢
fsaf	耩
fsb	耔
fsbg	耔
fsc	耙
fscn	耙
fsd	耨
fsdf	耨
fse	耗
fsen	耗
fsf	博
fsfc	耘
fsfg	堙
fsfj	耕
fsfy	博
fsh	霜
fshf	霜
fsi	耒
fsik	耥
fsit	耖
fsj	耦
fsjy	耦
fsk	坷
fskg	坷
fsn	耜
fsng	耜
fso	耧
fsod	耱
fsov	耧
fss	霖
fssu	霖
fsu	某
fsw	耠
fswk	耠
fsy	埔
fsyy	耪
ft	才
ft	都
ftb	孝
ftbf	孝
ftbt	教
ftd	嫠
ftdv	嫠
fte	雾
fte	才
fter	雾
ftf	霆
ftfp	霆
ftg	考
ftgn	考
fth	埏
fthp	埏
ftj	者
ftjb	都
ftjf	者
ftjn	翥
ftjo	煮
ftm	垧
ftmk	垧
ftn	埠
ftnf	埠
ftng	坞
ftnn	圪
ftx	老
ftxb	老
ftxe	耄
ftxf	耋
ftxj	耆
ftxu	霉
fu	增
fu	境
fue	丧
fueu	丧
fuf	幸
fufj	幸
fug	垃
fuj	境
fujq	境
fuk	培
fukg	培
ful	啬
fulj	增
fulk	啬
fuv	霎
fuvf	霎
fv	雪
fv	垠
fvf	雪
fvi	埭
fviy	埭
fvp	埽
fvph	埽
fvy	垠
fw	零
fw	霍
fwf	逵
fwfp	逵
fwn	堠
fwnd	堠
fws	垛
fwsy	垛
fww	赍
fwwm	赍
fwy	堆
fwyc	零
fwyf	霍
fwyg	堆
fwyn	埝
fx	坳
fx	坶
fxe	坳
fxet	坳
fxy	坶
fy	坊
fy	坑
fyb	墩
fybt	墩
fyj	霁
fyjj	霁
fyjn	霭
fyk	壤
fyke	壤
fyn	垓
fynw	垓
fyp	壕
fype	壕
fyr	垴
fyrb	垴
fyt	坊
fyu	雯
fyuk	墒
fyw	坑
fywn	坑
fyy	坟
g	一
g	王
ga	开
ga	型
gab	邢
gabh	邢
gae	形
gaet	形
gah	武
gahb	琊
gahg	鹉
gahy	武
gai	戋
gaj	弄
gajf	型
gajh	刑
gak	瑾
gak	开
gakg	瑾
gal	盏
galf	盏
gam	瑛
gamd	瑛
gamw	璜
gaw	珙
gawy	珙
gb	击
gb	顿
gbg	珥
gbk	击
gbn	屯
gbnm	顿
gbnv	屯
gby	玻
gc	到
gc	致
gcf	至
gcfb	郅
gcff	至
gcfj	到
gcft	致
gcft	臻
gcg	玛
gcgg	玛
gd	天
gd	环
gde	瑚
gdeg	瑚
gdh	环
gdhy	环
gdi	天
gdj	蚕
gdju	蚕
gdk	吞
gdkf	吞
gdm	顼
gdmy	顼
gdn	忝
gdnu	忝
gds	琦
gdsk	琦
gdw	琪
gdwy	琪
gdx	珑
gdxy	珑
ge	表
ge	青
gef	青
geg	瑗
gegc	瑗
gego	燹
gei	豕
gek	珈
gekg	珈
gem	靓
gemq	靓
gep	逐
gepc	瑷
geph	靛
gepi	逐
geq	静
geqh	静
get	瑶
getb	瑶
geu	表
gf	于
gf	玩
gfc	珐
gfcy	珐
gfk	于
gfl	盂
gflf	盂
gfn	玮
gfnh	玮
gfp	迂
gfpk	迂
gfq	玩
gfqn	玩
gg	五
gg	球
ggc	琶
ggcb	琶
gge	琢
ggey	琢
ggg	王
gggg	王
gggy	夫
ggh	五
gghg	五
ggi	球
ggiy	球
ggj	替
ggjf	替
ggl	辇
gglj	辇
ggll	一
ggn	瑟
ggnt	瑟
ggw	琴
ggwn	琴
ggx	琵
ggxx	琵
ggy	珏
ggyy	珏
gh	下
gh	正
ghd	正
ghg	焉
ghgb	鄢
ghge	璩
ghgo	焉
ghi	下
ghk	玷
ghkg	玷
ghn	丐
ghnu	忑
ghnv	丐
ghq	璨
ghqo	璨
ght	政
ghty	政
ghw	琥
ghwn	琥
gi	求
gi	救
gim	琐
gimy	琐
giy	救
giye	裘
giyi	求
giyp	逑
giyt	救
gj	理
gj	更
gjf	理
gjfg	理
gjg	亘
gjgf	亘
gjh	惠
gjhg	瑁
gjhn	惠
gjk	丌
gjr	更
gjri	更
gjx	琨
gjxx	琨
gk	事
gk	逼
gkf	吾
gkh	囊
gkhe	囊
gkhj	蠹
gkhk	璐
gkhs	橐
gkk	卅
gkkk	噩
gkl	副
gklj	副
gklp	逼
gkm	融
gkmh	鬲
gkmj	融
gkmn	翮
gkp	带
gkph	带
gkr	吏
gkri	吏
gku	豆
gkua	豇
gkub	豌
gkuc	豉
gkuf	豆
gkup	逗
gkv	事
gkvh	事
gl	画
gl	琏
glb	画
glbj	画
glp	琏
glpy	琏
gm	现
gm	两
gma	曹
gmaj	曹
gmap	遭
gmd	瑞
gmdj	瑞
gmf	再
gmfd	再
gmm	珊
gmmg	珊
gmmv	璎
gmq	规
gmqn	现
gmqn	规
gmu	责
gmw	丙
gmwb	邴
gmwi	丙
gmww	两
gmwy	璀
gmy	丽
gmyb	郦
gmyg	鹂
gmyp	逦
gmyy	丽
gn	与
gn	瓦
gna	珉
gnan	珉
gnd	琚
gndg	琚
gng	欤
gngd	与
gngw	欤
gnh	瑕
gnhc	瑕
gnn	瓦
gnny	瓦
go	亚
go	严
god	亚
gof	垩
goff	垩
goi	灭
goj	晋
goja	戬
gojf	晋
gon	恶
gonu	恶
goo	琰
gooy	琰
got	严
gote	严
gou	璞
goug	璞
gov	瑭
govk	瑭
gp	琛
gp	琮
gpf	琮
gpfi	琮
gpl	珲
gplh	珲
gpq	琬
gpqb	琬
gpws	琛
gq	万
gq	死
gqb	殛
gqbg	殛
gqc	殆
gqck	殆
gqe	殍
gqe	万
gqeb	殍
gqeg	殂
gqet	劢
gqf	殖
gqfh	殖
gqfu	殪
gqg	残
gqga	残
gqgy	麸
gqi	歹
gqiy	珧
gqj	列
gqje	裂
gqjh	列
gqji	虺
gqjo	烈
gqju	虿
gqk	殒
gqkh	趸
gqkm	殒
gqm	殃
gqmd	殃
gqp	迈
gqpe	迈
gqpw	殡
gqq	殉
gqqj	殉
gqt	殊
gqtb	聱
gqtd	獒
gqtf	歼
gqtf	殊
gqtg	鳌
gqtg	骜
gqtj	螯
gqtm	赘
gqto	熬
gqtp	遨
gqtq	鏊
gqtr	殇
gqty	敖
gqu	殚
gquf	殚
gqv	兀
gqw	餮
gqwc	殁
gqwe	殄
gqwg	殓
gqwv	餮
gqx	死
gqxv	死
gqy	玖
gqyy	玖
gr	珀
gr	碧
grd	碧
grdf	碧
grg	珀
grq	瑰
grqc	瑰
gs	末
gs	琳
gsh	玎
gsi	末
gsj	亍
gsk	珂
gskg	珂
gss	琳
gssy	琳
gt	麦
gt	珠
gtf	珠
gtfm	瓒
gtfy	珠
gtg	珩
gtgs	珩
gtk	珞
gtkg	珞
gtl	璁
gtln	璁
gtu	麦
gty	玫
gu	来
gu	平
gud	夹
gudb	郏
gudi	夹
gudm	颊
guf	平
gufk	平
guj	璋
gujh	璋
gus	赉
gusi	来
gusm	赉
gv	妻
gv	瑙
gvh	妻
gvhv	妻
gvt	瑙
gvtr	瑙
gw	珍
gwa	玳
gway	玳
gwe	珍
gwet	珍
gwg	瑜
gwgj	瑜
gwn	玑
gwv	玢
gwvt	玢
gwy	玲
gwyc	玲
gx	互
gx	素
gxd	互
gxh	纛
gxhi	纛
gxi	素
gxiu	素
gxu	毒
gxw	夷
gxwi	夷
gy	玉
gy	班
gyc	琉
gyck	琉
gyg	斑
gygg	斑
gyi	琼
gyi	玉
gyiy	琼
gyr	璃
gyrc	璃
gyt	班
gytg	班
gyth	璇
gyv	琅
gyvy	琅
gyy	玟
h	上
h	目
ha	瞒
ha	虐
hag	虐
hagd	虐
hagg	眶
hagw	瞒
hal	瞄
halg	瞄
har	眍
hary	眍
hc	眸
hc	睃
hck	眙
hckg	眙
hctg	眸
hcu	攴
hcw	睃
hcwt	睃
hd	非
hd	辈
hdf	睚
hdff	睚
hdh	悲
hdhd	非
hdhe	裴
hdhg	韭
hdhj	蜚
hdhl	辈
hdhn	翡
hdhn	悲
hdhy	斐
he	肯
he	瞬
hee	虏
hef	肯
heh	瞍
hehc	瞍
hep	瞬
hepg	瞬
heq	睨
heqn	睨
hes	睬
hesy	睬
hf	睦
hf	睹
hfc	歧
hfcl	瞌
hfcy	歧
hff	眭
hffg	眭
hft	睹
hftj	睹
hfw	睦
hfwf	睦
hg	睛
hg	凸
hgb	盹
hgbn	盹
hge	遽
hgeg	睛
hgep	遽
hgf	盱
hgfh	盱
hgh	凸
hghg	芈
hghg	凸
hghn	眄
hgu	睐
hgus	睐
hgv	睫
hgvh	睫
hh	步
hh	止
hhd	频
hhdf	颦
hhdm	频
hhg	止
hhgg	上
hhgg	止
hhgn	虍
hhh	目
hhhh	目
hhl	丨
hhll	丨
hhr	步
hhu	卡
hhw	瞿
hhwc	矍
hhwe	氍
hhwy	瞿
hhx	眦
hhxn	眦
hhy	卜
hi	叔
hi	督
hic	督
hich	督
hicy	叔
hip	瞠
hipf	瞠
hit	眇
hitt	眇
hj	旧
hj	桌
hjg	旧
hjj	卓
hjs	桌
hjsu	桌
hk	占
hk	点
hka	战
hkay	战
hkf	占
hkg	虞
hkgd	虞
hkm	觇
hkmq	觇
hkn	乩
hknn	乩
hko	点
hkou	点
hl	卤
hl	鹾
hln	卣
hlnf	卣
hlr	鹾
hlra	鹾
hlru	卤
hm	贞
hmu	贞
hn	虑
hn	鼎
hna	眠
hnan	眠
hnb	瞰
hnbt	瞰
hnd	鼎
hndm	颅
hndn	鼎
hnh	凹
hnhg	凹
hnhq	兕
hni	虑
hnq	鸬
hnqg	鸬
hnr	卢
hnt	瞩
hnty	瞩
hnu	忐
ho	虚
ho	眯
hod	虚
hom	觑
homq	觑
hoq	瞵
hoqg	瞵
hoy	眯
hp	瞎
hp	睿
hpd	瞎
hpdk	瞎
hpg	睿
hpgf	壑
hpgh	睿
hpj	瞑
hpju	瞑
hpq	眈
hpqn	眈
hq	餐
hq	睁
hqc	粲
hqco	粲
hqcv	餐
hqd	瞻
hqdy	瞻
hqi	眺
hqiy	眺
hqq	眵
hqqy	眵
hqv	睁
hqvh	睁
hr	睥
hrtf	睥
hs	盯
hs	瞟
hsf	瞟
hsfi	瞟
hsh	盯
ht	睡
ht	瞅
htf	睡
htfa	睡
hto	瞅
htoy	瞅
htp	眨
htpy	眨
hu	瞳
hu	睇
huj	瞳
hujf	瞳
hux	睇
huxt	睇
hv	眼
hvy	眼
hw	具
hw	虎
hwb	齿
hwbc	龄
hwbf	龌
hwbg	龃
hwbh	龊
hwbj	齿
hwbk	龉
hwbk	龆
hwbn	龅
hwbv	龈
hwbx	龇
hwbx	龀
hwby	龋
hwe	彪
hwee	彪
hwg	瞪
hwgd	睽
hwgg	睑
hwgu	瞪
hwu	具
hwv	虎
hwvt	盼
hwy	瞧
hwyg	睢
hwyo	瞧
hx	此
hx	些
hxd	砦
hxdf	砦
hxf	些
hxff	些
hxm	赀
hxmu	赀
hxn	此
hxq	觜
hxqe	觜
hxs	柴
hxsu	柴
hxw	雌
hxwy	雌
hxx	紫
hxxi	紫
hxy	訾
hxyf	訾
hy	眩
hy	虔
hyi	虔
hyx	眩
hyxy	眩
i	不
i	水
ia	江
ia	港
iad	漭
iada	漭
iag	满
iag	江
iagn	懑
iagw	满
iaj	漠
iajd	漠
iak	灌
iaky	灌
iam	潢
iamw	潢
ian	汇
iann	泄
ians	渠
ians	渫
iap	涝
iape	涝
iapi	潆
iapy	滢
iaq	鸿
iaqg	鸿
iar	沤
iary	沤
ias	柒
iasu	柒
iat	浇
iatq	浇
iav	沏
iavt	沏
iavw	潇
iaw	洪
iawn	港
iawy	洪
ib	波
ib	池
ibc	滠
ibcc	滠
ibe	泐
ibet	泐
ibg	洱
ibi	涵
ibib	涵
ibk	凼
ibn	池
ibv	婆
ibvf	婆
ibw	滁
ibws	滁
iby	汲
iby	波
ibyy	汲
ic	汉
ic	治
ica	泾
icag	泾
icd	渗
icde	渗
ice	涌
iceh	涌
icg	泽
icgh	泽
ick	治
ickg	治
icw	滩
icwt	浚
icwy	滩
icy	汊
icy	汉
icyy	汊
id	尖
id	湖
ide	湖
ideg	洧
ideg	湖
idet	沥
idf	涯
idff	溽
idff	涯
idg	沽
idh	沣
idhc	滟
idhh	沣
idi	尜
idiu	尜
idj	淹
idjn	淹
idl	湎
idlf	湎
idr	源
idri	源
idt	涛
idtf	涛
idu	潦
idu	尖
idui	潦
idw	湛
idwn	湛
idwr	澌
idwt	溱
idwy	淇
idx	泷
idxy	泷
idy	汰
idyy	汰
ie	肖
ie	浮
ieb	浮
iebg	浮
iec	淝
iecn	淝
iee	滔
ieeg	滔
ief	肖
ieg	沮
iegg	沮
ieh	溲
iehc	溲
iej	削
iejh	削
iep	逍
iepd	逍
iet	淫
ietf	淫
iex	溪
iexd	溪
if	汗
if	法
ifa	灞
ifae	灞
ifc	法
ifcl	溘
ifcy	法
ifd	濡
ifdj	濡
iff	尘
iffg	洼
ifg	泔
ifh	汁
ifh	汗
ifhw	滇
ifj	潮
ifje	潮
ifjn	瀚
ifk	洁
ifke	澎
ifkf	澍
ifkg	洁
ifn	污
ifnd	渎
ifnn	污
ifp	渤
ifpe	渤
ifq	沅
ifqn	沅
ift	渚
iftj	渚
ig	光
ig	举
iga	浅
igay	浅
igb	沌
igbn	沌
igd	添
igdn	添
ige	清
igeg	清
igey	涿
igg	汪
iggj	潜
igh	沔
ighn	沔
igj	洹
igjg	洹
igk	滞
igkg	浯
igkh	滞
igm	渍
igmh	沛
igmj	漕
igmy	渍
igq	耀
igqb	光
igqj	洌
igql	辉
igqy	耀
igs	沫
igsy	沫
igu	浃
igud	浃
igus	涞
igw	兴
igwg	举
igwu	兴
igwy	誉
ih	小
ih	泪
ihg	泪
ihh	涉
ihhm	濒
ihht	涉
ihi	淑
ihic	淑
ihit	渺
ihj	淖
ihjh	淖
ihk	沾
ihkg	沾
ihm	浈
ihmy	浈
ihn	滤
ihnt	泸
ihny	滤
ihq	瀣
ihqg	瀣
iht	滹
ihtf	滹
ihty	小
ihw	濉
ihwy	濉
ii	水
ii	消
iie	消
iieg	消
iii	淼
iiii	水
iiiu	淼
iim	淌
iimk	淌
iit	沙
iite	裟
iitg	鲨
iitr	挲
iitt	沙
iitv	娑
ij	浊
ij	温
ija	瀑
ijai	瀑
ijf	沓
ijfg	涅
ijg	汩
ijg	汨
ijl	温
ijlc	漫
ijlg	温
ijn	溻
ijng	溻
ijo	湿
ijog	湿
ijq	渴
ijqn	渴
ijt	滥
ijtl	滥
ijx	混
ijxx	混
ijy	灏
ijy	浊
ijym	灏
ik	溃
ik	澡
ike	涓
ikeg	涓
ikh	潞
ikhk	潞
ikhm	溃
ikhy	浞
ikj	渑
ikjn	渑
ikk	澡
ikkn	漶
ikks	澡
ikm	涡
ikmw	涡
il	渐
il	渭
ild	涸
ildg	涸
ildy	洇
ile	渭
ileg	渭
ilf	涠
ilfh	涠
ilg	泗
ilge	溷
ilgj	淠
ilk	洄
ilkg	洄
ilp	涟
ilpy	涟
ilr	渐
ilrh	渐
ilw	泅
ilwy	泅
ilx	漯
ilxi	漯
im	油
im	尚
ima	澧
imau	澧
imd	湍
imdj	湍
imdy	泱
ime	滑
imeg	滑
img	洞
img	油
imga	溅
imgk	洞
imh	汕
imj	测
imjh	测
imk	尚
imke	氅
imkf	尚
imkt	敞
imw	涔
imwn	涔
in	沁
in	泥
ina	泯
inan	泯
inb	潺
inbb	潺
inbt	澉
inf	漏
infh	汛
infy	漏
ing	渥
ingf	渥
inh	湄
inhg	湄
inm	涮
inmj	涮
inn	汜
inr	汤
inro	烫
inrt	汤
int	泌
intt	泌
inty	泼
inw	濯
inwy	濯
inx	泥
inxn	泥
iny	沁
io	渡
io	淡
ioa	渡
ioac	渡
iol	瀵
iolw	瀵
ioo	淡
iooy	淡
iou	濂
iouw	濂
iov	溏
iovk	溏
iox	漉
ioxx	漉
ip	党
ip	深
ipa	黉
ipaw	黉
ipb	学
ipbf	学
ipe	浓
ipey	浓
ipf	尝
ipfc	尝
ipfi	淙
ipfq	浣
ipg	泻
ipgg	渲
ipgg	泻
ipgh	淀
ipgw	演
ipi	泶
ipiu	泶
ipj	溟
ipjh	渖
ipju	溟
ipk	常
ipke	裳
ipkf	堂
ipkh	常
ipkm	赏
ipkq	党
ipkr	掌
ipks	棠
ipl	浑
iplh	浑
ipm	觉
ipmq	觉
ipn	涫
ipng	涫
ipq	沈
ipqg	鲎
ipqn	沈
ipr	滨
iprw	滨
ips	泞
ipsh	泞
ipt	喾
iptk	喾
ipu	滓
ipuh	滓
ipw	沉
ipwk	溶
ipwn	沉
ipws	深
ipx	沱
ipxn	沱
iq	沟
iq	溜
iqc	沟
iqcy	沟
iqd	澹
iqdy	澹
iqg	淦
iqgg	渔
iqi	洮
iqiy	洮
iqj	洵
iqjg	洵
iqk	浼
iqkq	浼
iqm	涣
iqmd	涣
iqn	泡
iqnn	泡
iqt	淘
iqtb	泖
iqtb	淘
iqtj	潴
iqtk	漪
iqy	汐
iqyl	溜
ir	汽
ir	派
irb	汹
irbh	汹
ird	淆
irde	淆
irdf	湃
irdh	浠
ire	派
irey	派
irg	泊
irgg	湟
irh	沂
irn	汽
irr	浙
irrh	浙
irw	浜
irwy	浜
iry	激
iryt	激
is	浦
is	酒
isf	漂
isfg	湮
isfi	漂
isfy	溥
isg	洒
isgg	酒
ish	汀
ishg	湘
isj	潭
isjg	渣
isjh	潭
isk	河
iskg	涑
iskg	河
iskm	濑
iskw	漱
isr	淅
isrh	淅
iss	淋
isse	潸
issv	漤
issy	溧
issy	淋
isw	漆
iswc	淞
iswi	漆
isy	沐
isy	浦
isyy	沭
it	少
it	省
ita	弊
itaj	弊
itb	沲
itbn	沲
itd	活
itdg	活
itdq	鋈
itdy	沃
ite	劣
ite	少
iten	滗
iter	劣
itf	洗
itfk	浩
itfq	洗
itfy	洙
itg	洚
itgh	洚
ith	省
ithd	溴
ithf	瞥
ithf	省
ithg	洎
ithj	濞
ithp	涎
iti	潲
itie	潲
itk	洛
itkg	洛
itkh	蹩
itl	洫
itlg	洫
itm	澳
itmd	澳
itn	憋
itni	泺
itnn	汔
itnu	憋
ito	潘
itoh	渊
itol	潘
itoy	湫
itp	泛
itpy	泛
itq	鳖
itqg	鳖
its	涤
itsy	涤
itx	海
itxy	海
ity	敝
iu	洋
iu	滚
iub	溯
iube	溯
iuc	滚
iuce	滚
iue	湔
iuej	湔
iug	泣
iugg	润
iugh	泮
iugi	漾
iuh	洋
iuj	漳
iujf	潼
iujg	涧
iujh	漳
iuk	涪
iukg	涪
ius	澜
iusl	澜
iuw	溢
iuwl	溢
iux	滋
iuxt	涕
iuxx	滋
iv	当
iv	津
iva	溉
ivaq	溉
ivf	浔
ivf	当
ivfy	浔
ivg	汝
ivgh	津
ivi	渌
iviy	渌
ivk	沼
ivkg	洳
ivkg	沼
ivl	淄
ivlg	淄
ivp	浸
ivpc	浸
ivs	染
ivsu	染
ivw	梁
ivwo	粱
ivws	梁
ivy	涩
ivyh	涩
iw	没
iw	涂
iwb	沧
iwbn	沧
iwc	没
iwcy	没
iwe	脊
iwef	脊
iwf	浍
iwfc	浍
iwg	洽
iwga	瀹
iwgc	溆
iwgj	渝
iwgk	洽
iwgs	涂
iwgt	潋
iwgu	澄
iwk	沿
iwkg	沿
iwo	濮
iwog	濮
iwr	滏
iwru	滏
iwv	汾
iwvl	湓
iwvt	汾
iww	浴
iwwk	浴
iwx	沦
iwxn	沦
iwy	淮
iwyc	泠
iwyf	雀
iwyg	淮
ix	涨
ix	沸
ixc	泓
ixcy	泓
ixj	沸
ixjh	沸
ixt	涨
ixty	涨
ixu	溺
ixuu	溺
ixw	潍
ixwy	潍
iy	济
iy	游
iyb	淳
iybg	淳
iyc	流
iyck	流
iycq	鎏
iyct	澈
iye	瀛
iyey	沩
iyey	瀛
iyg	注
iygg	注
iyh	汴
iyhy	汴
iyj	浏
iyjh	济
iyjh	浏
iyl	澶
iylg	澶
iyn	沪
iyni	泳
iynt	沪
iyo	湾
iyos	滦
iyox	湾
iyp	濠
iype	濠
iyr	漓
iyrc	漓
iyt	洲
iytb	游
iytf	浒
iyth	漩
iyth	洲
iyu	滴
iyud	滴
iyuy	滂
iyv	浪
iyvy	浪
iyw	液
iywf	淬
iywn	沆
iywu	淤
iywy	液
iyx	泫
iyxy	泫
iyy	汶
iyyg	氵
j	是
j	日
ja	晓
ja	暴
jad	蟒
jada	蟒
jag	虹
jagw	螨
jah	蚜
jaht	蚜
jaj	蜡
jajd	蟆
jajg	蜡
jak	蜮
jakg	蜮
jal	蠛
jalw	蠛
jam	蟥
jamw	蟥
jan	蝶
jans	蝶
jap	蝾
jape	蠓
japs	蝾
jat	蛲
jatq	晓
jatq	蛲
jaw	暴
jawc	蠖
jawi	暴
jb	最
jb	蜢
jbc	最
jbcu	最
jbl	蜢
jblg	蜢
jc	坚
jc	紧
jce	肾
jcef	肾
jceh	蛹
jcf	蛏
jcff	坚
jcfg	蛏
jcg	蚂
jcgg	蚂
jcm	贤
jcmu	贤
jct	蛑
jctg	蛑
jcu	竖
jcuf	竖
jcx	紧
jcxi	紧
jd	晨
jd	蝴
jde	蝴
jdeg	蝴
jdf	蝰
jdfe	晨
jdff	蝰
jdg	蛄
jdgq	蛎
jdh	蚌
jdhh	蚌
jdn	晟
jdnb	晟
jdr	螈
jdri	螈
jdw	螓
jdwj	蝽
jdwt	螓
jdwu	昃
jdwy	蜞
je	明
je	暖
jeb	蜉
jebg	蜉
jeg	暖
jeg	明
jegc	暖
jegg	蛆
jeh	螋
jehc	螋
jel	盟
jelf	盟
jen	蚝
jep	暧
jepc	暧
jf	时
jf	里
jfc	野
jfcf	墅
jfch	野
jfcu	昙
jfd	里
jfdj	蠕
jff	蛙
jffg	蛙
jfg	蚶
jfh	旰
jfj	旱
jfk	蟛
jfke	蟛
jfm	蝻
jfmf	蝻
jft	暑
jftj	暑
jfy	昧
jfy	时
jg	量
jg	虾
jgc	蛭
jgcf	蛭
jgd	昊
jgdu	昊
jge	晴
jgeg	蜻
jgeg	晴
jgf	旦
jgg	旺
jgh	题
jghh	韪
jghm	题
jghu	是
jghx	匙
jghy	虾
jgj	蟪
jgjf	量
jgjn	蟪
jgk	晤
jgkg	晤
jgkl	蝠
jgm	师
jgmh	师
jgmj	螬
jgu	蛱
jgud	蛱
jgy	蚨
jh	早
jh	冒
jhe	勖
jhet	勖
jhf	冒
jhh	刂
jhhc	蠼
jhk	申
jhn	畅
jhng	曰
jhnh	早
jhnr	畅
jhny	虫
ji	晃
ji	螳
jie	蛸
jieg	蛸
jig	晃
jigq	晃
jip	螳
jipf	螳
jj	昌
jj	晶
jja	曝
jjai	曝
jjf	昌
jjg	蛳
jjgh	蛳
jjj	晶
jjjf	晶
jjjj	日
jjq	蝎
jjqn	蝎
jjqr	蜴
jjs	蜾
jjsy	蜾
jk	蝇
jk	蜗
jkg	蜈
jkgd	蜈
jkj	蝇
jkjn	蝇
jkm	蜗
jkmw	蜗
jl	曙
jl	曼
jlc	曼
jlcu	曼
jlf	蛊
jlfj	曙
jlg	蝈
jlgy	蝈
jlk	蛔
jlkg	蛔
jlx	螺
jlxi	螺
jm	遇
jm	愚
jma	蛐
jmag	蛐
jmd	映
jmdy	映
jmf	蚺
jmfg	蚺
jmfk	蜩
jmg	蚰
jmh	帅
jmhh	帅
jmhn	愚
jmhp	遇
jmhy	禺
jmq	蚬
jmqn	蚬
jmw	蚋
jmwy	蚋
jn	电
jn	昵
jnh	暇
jnhc	暇
jnn	虬
jnp	遢
jnpd	遢
jnt	曳
jnte	曳
jnv	电
jnw	曜
jnwy	曜
jnx	昵
jnxn	昵
jo	显
jo	旷
jof	显
jot	旷
jou	炅
jouw	蠊
jov	蝼
jovg	蝼
jovk	螗
jp	蛇
jp	晖
jpg	暄
jpgg	暄
jpj	螟
jpju	暝
jpju	螟
jpl	晕
jplh	晖
jplj	晕
jpq	蜿
jpqb	蜿
jpv	晏
jpvf	晏
jpx	蛇
jpxn	蛇
jq	晚
jq	易
jqb	昂
jqbj	昂
jqd	蟾
jqdy	蟾
jqi	晁
jqiu	晁
jqk	冕
jqke	蟓
jqko	煦
jqkq	晚
jqkq	冕
jqr	易
jqrj	剔
jqrr	易
jqt	昴
jqtb	昴
jqu	昀
jqug	昀
jqw	遏
jqwn	曷
jqwp	遏
jqww	歇
jr	蝗
jr	昕
jrg	蚯
jrgg	蝗
jrh	昕
jrt	蜱
jrtf	蜱
js	果
js	颗
jsd	颗
jsdm	颗
jsf	螵
jsfi	螵
jsg	晒
jsi	果
jsk	蚵
jskg	蚵
jsq	夥
jsqq	夥
jsr	晰
jsrh	蜥
jsrh	晰
jsu	杲
jsy	晡
jt	鉴
jt	临
jtd	蜂
jtdg	蛞
jtdh	蜂
jtdk	蜘
jtf	蛛
jtfp	蜓
jtfy	蛛
jtg	星
jtga	戥
jtgf	星
jtgo	曛
jth	昨
jthf	蚱
jthf	昨
jthk	晷
jthn	螅
jthp	蜒
jtj	蝮
jtjh	蜊
jtjt	蝮
jtm	晌
jtmk	晌
jtn	虼
jtnn	虼
jto	蟋
jtol	蟠
jton	蟋
jtr	蛾
jtry	蛾
jtu	蝌
jtuf	蝌
jtx	晦
jtxy	晦
jty	览
jtyj	临
jtyl	监
jtyq	鉴
jtyq	览
ju	暗
ju	曦
juf	昱
jufh	蚪
jug	曦
jugb	蜷
jugy	曦
juh	蛘
juj	蝉
jujf	蝉
jujg	暗
jujh	蟑
juk	蜕
jukq	蜕
jun	蜣
junn	蜣
jur	蛟
jury	蛟
jus	蝤
jusg	蝤
juu	蟮
juuk	蟮
jv	归
jv	照
jvb	旯
jvg	归
jvk	昭
jvkg	昭
jvko	照
jw	蛤
jw	晗
jwc	蚣
jwcy	蚣
jwg	蜍
jwgd	暌
jwgj	蝓
jwgk	蛤
jwgs	蜍
jwj	蚧
jwjh	蚧
jwn	虮
jwx	晔
jwxf	晔
jwy	暹
jwyc	蛉
jwyk	晗
jwyp	暹
jx	昆
jx	蚓
jxe	蚴
jxet	蚴
jxh	蚓
jxhh	蚓
jxx	蚍
jxxb	昆
jxxn	蚍
jy	影
jy	景
jyb	暾
jybt	暾
jyg	蛀
jygg	蛀
jyi	景
jyie	影
jyim	颢
jyiu	景
jyiy	晾
jyj	蛴
jyjh	蛴
jyk	曩
jyke	曩
jyn	蝙
jyna	蝙
jynn	虻
jyr	蚁
jyrc	螭
jyry	蚁
jyt	蝣
jytb	蝣
jyu	螃
jyuy	螃
jyv	螂
jyvb	螂
jyx	蟀
jyxf	蟀
jyy	蚊
k	中
k	口
ka	呀
ka	哎
kad	喏
kadk	喏
kaf	嘞
kafe	嘞
kag	哐
kagg	哐
kah	呀
kaht	呀
kaj	噶
kajn	噶
kal	喵
kalg	喵
kam	咂
kamh	咂
kan	喋
kann	呓
kans	喋
kap	唠
kape	唠
kar	哎
kary	呕
kary	哎
kat	哓
katq	哓
kaw	哄
kawk	嗒
kawk	嗬
kawy	哄
kay	嚆
kayk	嚆
kb	啊
kb	吸
kbc	嗫
kbcc	嗫
kbh	叩
kbhj	嗤
kbm	咄
kbmh	咄
kbn	吼
kbnn	吼
kbny	戢
kbs	啊
kbsk	啊
kby	吸
kbyy	吸
kc	吧
kc	吗
kcb	邑
kcc	嗓
kccc	啜
kccs	嗓
kce	嗵
kcep	嗵
kcg	吗
kcgg	吗
kcn	吧
kcq	吮
kcqn	吮
kct	唉
kctd	唉
kctg	哞
kcw	唆
kcwt	唆
kcy	叹
kd	顺
kd	喊
kdb	呃
kdbn	呃
kde	呖
kdet	呖
kdf	喹
kdff	喹
kdg	咕
kdgk	喊
kdh	嘎
kdha	嘎
kdhg	呸
kdhi	嘁
kdht	嗄
kdj	喱
kdjf	喱
kdm	顺
kdmy	顺
kdo	咴
kdoy	咴
kdp	哒
kdpy	哒
kdu	噘
kdui	嘹
kduw	噘
kdw	嘶
kdwg	唪
kdwr	嘶
kdwt	嗪
kdx	咙
kdxy	咙
kdy	吠
kdyy	呔
ke	另
ke	别
keg	咀
kegg	咀
keh	嗖
kehc	嗖
kej	别
kejh	别
kek	咖
kekg	咖
kel	嚼
kelf	嚼
kep	嗳
kepc	嗳
keq	鹃
keqg	鹃
ker	另
ket	叻
kf	叶
kf	味
kfa	喷
kfam	喷
kfc	吱
kfcl	嗑
kfcy	吱
kfd	嚅
kfdj	嚅
kff	哇
kffg	哇
kfg	吐
kfh	嗔
kfh	叶
kfhw	嗔
kfj	嘲
kfje	嘲
kfk	嘻
kfke	嘭
kfkg	咭
kfkk	嘻
kfl	鄙
kflb	鄙
kfm	喃
kfmf	喃
kfo	哧
kfoy	哧
kfp	噎
kfph	嚏
kfpi	嗦
kfpu	噎
kfq	呒
kfqn	呒
kft	哮
kftb	嘟
kftb	哮
kftj	嗜
kfw	嚯
kfwy	嚯
kfy	味
kg	号
kg	吴
kgb	吨
kgbh	郢
kgbn	吨
kgd	吴
kgdu	吴
kge	啄
kgey	啄
kgf	呈
kgfh	吁
kgh	吓
kghy	吓
kgj	哽
kgjr	哽
kgk	唔
kgke	囔
kgkg	唔
kgkh	嗝
kgm	啧
kgmj	嘈
kgmy	啧
kgn	饕
kgnb	号
kgnv	饕
kgo	哑
kgog	哑
kgp	逞
kgpd	逞
kgq	嗷
kgqj	咧
kgqt	嗷
kgt	唛
kgty	唛
kgx	咦
kgxi	嗉
kgxw	咦
kgy	呋
kh	足
kh	贵
kha	距
khaj	躇
khan	距
khaq	跷
khas	蹀
khaw	蹒
khay	躏
khb	跛
khbc	蹑
khby	趿
khby	跛
khc	踊
khce	踊
khck	跆
khcs	蹂
khd	跨
khdd	啡
khdf	踌
khdf	蹰
khdg	跖
khdn	跨
khdw	蹶
khdy	跋
khe	啃
khed	蹊
khee	蹈
kheg	啃
khek	跏
khes	踩
khf	跬
khff	跬
khg	践
khga	趼
khga	践
khge	噱
khgm	贵
khgp	遗
khgp	遣
khgy	趺
khh	趾
khhg	趾
khhj	踔
khhy	咔
khi	踏
khij	踏
khj	踢
khjn	蹋
khjr	踢
khjs	踝
khk	躁
khk	中
khks	躁
khl	盅
khlf	盅
khlj	躅
khm	蹦
khme	蹦
khmg	跚
khmj	踹
khn	忠
khnd	踞
khnn	跽
khnu	忠
kho	嘘
khoc	踱
khof	躔
khog	蹼
khog	嘘
khok	踮
khp	踪
khph	蹿
khpi	踪
khpx	跎
khq	跑
khqb	跪
khqi	跳
khqn	跑
khqy	趵
khr	踬
khrm	踬
kht	路
khtd	跃
khtf	踵
khtg	跌
khtg	鹭
khti	跞
khtk	踟
khtk	路
khtl	蹯
khtm	躜
khtp	跹
khtq	跣
khty	踽
khu	蹲
khu	足
khua	蹉
khub	踯
khuf	蹲
khuj	蹭
khuk	踣
khur	跤
khv	跟
khvn	躐
khvp	踺
khvy	跟
khw	趴
khwb	跄
khwb	啮
khwf	跗
khwn	唬
khws	跺
khwu	蹬
khwy	趴
khx	嘴
khxe	嘴
khxf	跸
khxn	呲
khy	卟
khya	蹁
khyc	躞
khyh	蹄
khyj	跻
khyv	踉
khyy	蹴
ki	吵
ki	嗨
kib	啵
kiby	啵
kie	哨
kieg	哨
kig	咣
kigq	咣
kim	唢
kimy	唢
kit	嗨
kitt	吵
kitx	嗨
kj	虽
kj	唱
kjb	嘬
kjbc	嘬
kjf	哩
kjfg	哩
kjh	呻
kjhh	呻
kjj	唱
kjjg	唱
kjm	喁
kjmy	喁
kjn	黾
kjnb	黾
kjq	喝
kjqn	喝
kju	虽
kk	吕
kk	哭
kkc	骂
kkcg	骂
kkd	器
kkdk	嚣
kkdk	器
kkdu	哭
kkf	鄂
kkf	吕
kkfb	鄂
kkfg	鹗
kkfm	颚
kkh	串
kkhk	串
kkhn	患
kkk	品
kkkf	品
kkkk	口
kkks	噪
kkl	鼍
kkln	鼍
kkw	咒
kkwb	咒
kl	喂
kl	嗯
kld	咽
kldn	嗯
kldy	咽
kle	喟
kleg	喟
klf	嘿
klfo	嘿
klfy	啭
klge	喂
klh	呷
km	员
km	吊
kma	嗣
kmak	嗣
kmb	郧
kmbh	郧
kmd	喘
kmdj	喘
kme	勋
kmee	嘣
kmet	勋
kmf	啁
kmfk	啁
kmh	吊
kmhj	吊
kmm	嘤
kmmv	嘤
kmq	哕
kmqy	哕
kmu	员
kmw	呐
kmwj	剐
kmwu	呙
kmwy	呐
kmy	呗
kn	叫
kn	哪
kng	叼
kngb	哪
kngf	喔
kngg	叼
knh	叫
knhh	叫
knk	噼
knku	噼
knm	唰
knmj	唰
knt	嘱
knty	嘱
knx	呢
knxn	呢
kny	吣
ko	嘛
ko	咪
koo	啖
kooy	啖
kos	嘛
koss	嘛
kou	噗
koug	噗
kov	喽
kovg	喽
koy	咪
kp	喧
kp	喀
kpa	噻
kpaf	噻
kpe	哝
kpey	哝
kpg	啶
kpgg	喧
kpgh	啶
kpn	嘧
kpnm	嘧
kps	咛
kpsh	咛
kpt	喀
kpta	咤
kptk	喀
kpw	嚓
kpwi	嚓
kq	兄
kq	吹
kqb	兄
kqg	鸣
kqgg	鸣
kqgj	噜
kqm	唤
kqmd	唤
kqn	咆
kqnn	咆
kqq	哆
kqqy	哆
kqr	吻
kqrn	唿
kqrt	吻
kqt	啕
kqtb	啕
kqw	吹
kqwy	吹
kr	听
kr	史
kra	唣
kran	唣
krc	呱
krcy	呱
krd	唏
krdf	嗥
krdh	唏
kre	哌
krey	哌
krh	听
kri	史
krr	啪
krrg	啪
krrh	哳
krt	啤
krtf	啤
kru	啦
krug	啦
ks	呆
ks	叮
ksf	嘌
ksfi	嘌
ksg	哂
ksh	叮
ksj	喳
ksjg	喳
ksk	呵
kskg	呵
kskj	喇
kskw	嗽
kss	噤
kssi	噤
kssy	啉
ksu	呆
ksy	哺
kt	吃
kt	响
kta	噬
ktan	吒
ktaw	噬
ktf	唾
ktfa	唾
kth	咱
kthd	嗅
kthf	咋
kthg	咱
kthh	川
ktk	咯
ktkg	咯
ktm	响
ktmd	噢
ktmk	响
ktn	呜
ktng	呜
ktnn	吃
kto	啾
ktoy	啾
ktr	哦
ktry	哦
ktu	呼
ktuf	呼
ktuy	咚
ku	咬
ku	噫
kua	嗟
kuag	嗟
kub	嗍
kube	嗍
kuh	咩
kuhh	吖
kuj	喑
kujg	喑
kujn	噫
kul	噌
kulj	噌
kur	咬
kury	咬
kuv	唼
kuvg	唼
kuw	嗌
kuwl	嗌
kv	啸
kv	叨
kvb	唧
kvbh	唧
kvc	呶
kvcy	呶
kvh	啸
kvhw	啸
kvt	叨
kvy	哏
kw	只
kw	啥
kwb	呛
kwbn	呛
kwc	嗡
kwcn	嗡
kwf	咐
kwfc	哙
kwfk	啥
kwfy	咐
kwg	哈
kwgj	喻
kwgk	哈
kwgu	噔
kwn	叽
kwnd	喉
kwr	嗲
kwrq	嗲
kws	咻
kwsy	哚
kwsy	咻
kwu	只
kwv	吩
kwvt	咿
kwvt	吩
kww	唑
kwwf	唑
kwx	哗
kwxf	哗
kwy	叭
kwyc	呤
kwyc	噙
kwyg	唯
kwyn	吟
kwyo	噍
kx	哟
kx	叱
kxe	呦
kxet	呦
kxey	喙
kxh	吲
kxhh	吲
kxn	叱
kxq	哟
kxqy	哟
kxx	咝
kxxf	哔
kxxg	咝
kxxn	吡
kxxr	喈
kxy	吆
ky	唁
ky	咳
kyb	哼
kybh	哼
kyc	唷
kyce	唷
kyg	唁
kyj	哜
kyjh	哜
kyk	嚷
kyke	嚷
kyn	咏
kynd	唳
kyni	咏
kynw	咳
kyp	嚎
kype	嚎
kyt	嗾
kytd	嗾
kyu	啼
kyud	嘀
kyuh	啼
kyv	啷
kyvb	啷
kyw	吭
kywf	啐
kywn	吭
l	国
l	田
la	羁
la	轼
laa	轼
laay	轼
laf	羁
lafg	羁
lb	辄
lb	囝
lbd	囝
lbn	辄
lbnn	辄
lbw	墼
lbwf	墼
lc	轻
lc	辍
lca	轻
lcag	轻
lcc	轰
lccc	辍
lccu	轰
ld	因
ld	恩
ldb	轭
ldbn	轭
ldd	固
lde	囿
lded	囿
ldf	罟
ldg	轱
ldh	罘
ldhu	罘
ldi	因
ldj	罨
ldjn	罨
ldn	恩
ldnu	恩
lds	畸
ldsk	畸
ldt	畴
ldtf	畴
ldw	辏
ldwd	辏
ldy	畎
le	男
le	胃
lef	胃
ler	男
lev	嬲
leve	嬲
lf	团
lf	围
lfc	罢
lfco	罴
lfcu	罢
lff	畦
lffg	畦
lfh	轩
lfhf	置
lfk	辕
lfke	辕
lfm	罱
lfmf	罱
lfn	转
lfnh	围
lfny	转
lfo	黑
lfod	默
lfod	黩
lfoe	黝
lfoe	黪
lfof	墨
lfoi	黥
lfoj	黯
lfok	黠
lfom	黜
lfon	黔
lfoq	黟
lfot	黢
lfou	黑
lfq	园
lfqv	园
lft	署
lfte	团
lftj	署
lfu	圉
lfuf	圉
lg	车
lg	辆
lgb	囤
lgbn	囤
lgc	轾
lgcf	轾
lge	畏
lged	圊
lgeu	畏
lgh	罡
lghf	罡
lgj	畀
lgjj	畀
lgk	辐
lgkd	圄
lgkl	辐
lgm	辆
lgmw	辆
lgn	车
lgnh	车
lgyi	国
lh	四
lh	甲
lhd	罪
lhdd	罪
lhj	罩
lhjj	罩
lhn	皿
lhng	囗
lhng	四
lhng	皿
lhnh	甲
lhnt	轳
lj	辊
ljx	辊
ljxx	辊
lk	回
lk	圆
lkb	辑
lkbg	辑
lkd	回
lkf	軎
lkm	圆
lkmi	圆
lkw	轵
lkwy	轵
ll	田
ll	圜
llg	圜
llge	圜
lll	田
llll	田
lm	轴
lm	辋
lmg	轴
lmu	辋
lmun	辋
ln	思
ln	轧
lna	辗
lnae	辗
lnn	轧
lnu	思
lnw	罹
lnwy	罹
lo	辘
lo	辚
loq	辚
loqg	辚
loxx	辘
lp	连
lp	辖
lpd	辖
lpdk	辖
lpk	连
lpq	畹
lpqb	畹
lq	罗
lq	软
lqg	鸭
lqgg	鸭
lqj	蜀
lqju	蜀
lqp	逻
lqpi	逻
lqr	囫
lqre	囫
lqu	罗
lqw	软
lqwy	软
lr	斩
lr	暂
lrc	畈
lrcy	畈
lrf	堑
lrff	堑
lrh	斩
lrj	暂
lrjf	暂
lrq	錾
lrqf	錾
lrs	椠
lrsu	椠
ls	困
ls	辅
lsh	町
lsi	圃
lsi	困
lsk	轲
lskg	轲
lsy	辅
lt	略
lt	图
ltd	轿
ltdj	轿
ltg	轶
ltgy	轶
ltk	辂
ltkg	略
ltkg	辂
ltn	轹
ltni	轹
ltu	图
ltuf	轷
ltui	图
lty	畋
lu	较
lu	圈
lug	畔
lugb	圈
lugh	畔
luj	疃
lujf	疃
lul	罾
lulj	罾
lur	较
lury	较
lv	轨
lv	囡
lvd	囡
lvk	轺
lvkg	轺
lvl	辎
lvlg	辎
lvn	轨
lvy	轫
lvyy	轫
lw	界
lw	轮
lwe	轸
lwet	畛
lwet	轸
lwg	输
lwgg	辁
lwgj	输
lwi	囚
lwj	界
lwjj	界
lwx	轮
lwxn	轮
lwxv	囵
lwy	囹
lwyc	囹
lx	累
lx	毗
lxi	累
lxiu	累
lxx	毗
lxxk	辔
lxxn	毗
ly	罚
ly	辙
lyc	辙
lyct	辙
lyf	詈
lyj	罚
lyjj	罚
m	同
m	山
ma	曲
ma	贼
mad	贼
mad	曲
madt	贼
mah	岈
maht	岈
mai	岽
maiu	岽
map	嵘
mape	崂
maps	嵘
mar	岖
mary	岖
maw	典
mawu	典
mb	邮
mb	岌
mbh	邮
mby	岌
mbyu	岌
mc	峻
mc	贻
mcb	岜
mcg	峄
mcgh	峄
mck	贻
mckg	贻
mcw	峻
mcwt	峻
md	央
md	岸
mde	贿
mdeg	贿
mdf	岩
mdfe	赈
mdff	崖
mdfj	岸
mdg	岵
mdgv	崴
mdh	酆
mdhb	酆
mdi	央
mdj	崦
mdjn	崦
mdl	盎
mdlf	盎
mdm	颛
mdmm	颛
mdmp	遄
mdo	炭
mdou	炭
mdq	鸯
mdqg	鸯
mds	崎
mdsk	崎
me	骨
me	胄
med	髓
medg	骷
medp	髓
mee	崩
meef	崩
mef	胄
mef	骨
mej	髁
mejs	髁
mel	髑
melj	髑
meo	髅
meov	髅
mep	髋
mepk	髂
mepq	髋
mepw	髌
meq	鹘
meqg	鹘
meqy	骶
mer	髀
merf	髀
merk	骺
met	骼
metk	骼
mew	骰
mewc	骰
mewj	骱
mey	骸
meyw	骸
mf	财
mf	周
mfc	岐
mfcy	岐
mfd	冉
mff	峙
mffy	峙
mfh	巅
mfhm	巅
mfk	周
mfkd	周
mfky	雕
mfn	赎
mfnd	赎
mfq	嵌
mfqw	嵌
mft	赌
mftj	赌
mftt	财
mg	赋
mg	贱
mga	贱
mgah	岍
mgay	赋
mgay	贱
mge	豳
mgee	豳
mgi	赇
mgiy	赇
mgk	同
mgkd	同
mgn	屿
mgng	屿
mgu	峡
mgud	峡
mgus	崃
mh	由
mh	贝
mhb	帔
mhby	帔
mhd	帱
mhdf	帱
mhf	帏
mhfh	帏
mhg	幅
mhgl	幅
mhgm	帻
mhh	帧
mhhk	帖
mhhm	帧
mhj	帽
mhjc	幔
mhjh	帽
mhjq	幌
mhk	巾
mhkg	贴
mhkw	帜
mhl	帼
mhly	帼
mhn	冂
mhnf	幄
mhng	由
mhny	贝
mho	幞
mhog	幞
mhr	帕
mhrg	帕
mht	帐
mhtg	帙
mhtl	幡
mhty	帐
mhu	幢
mhuf	幢
mhuj	幛
mhw	帆
mhwy	帷
mhwy	帆
mi	峭
mi	嵴
mie	峭
mieg	峭
miw	嵴
miwe	嵴
mj	则
mj	赐
mjh	则
mjq	赐
mjqr	赐
mjv	岿
mjvf	岿
mk	迥
mk	贶
mkpd	迥
mkq	贶
mkqn	贶
ml	崭
ml	岬
mld	崮
mldf	崮
mlh	岬
mln	崽
mlnu	崽
mlr	崭
mlrj	崭
mm	册
mm	删
mmg	岫
mmgd	册
mmgj	删
mmgk	峒
mmm	山
mmmm	山
mmq	岘
mmqn	岘
mmr	岗
mmru	岗
mmt	罂
mmtb	罂
mmv	婴
mmvf	婴
mmvg	鹦
mn	岂
mn	凯
mna	岷
mnan	岷
mnb	崛
mnb	岂
mnbm	崛
mnh	嵋
mnhg	嵋
mnj	剀
mnjh	剀
mnm	觊
mnmq	觊
mnn	屺
mnw	凯
mnwn	凯
mny	赆
mnyu	赆
mo	赃
mo	嶙
mof	赃
mofg	赃
moo	赕
mooy	赕
moq	嶙
moqg	嶙
mov	嵝
movg	嵝
mp	迪
mp	崇
mpd	迪
mpf	崇
mpfi	崇
mpg	贮
mpgg	贮
mpw	崆
mpwa	崆
mq	见
mq	岁
mqb	见
mqc	购
mqcy	购
mqd	赡
mqdy	赡
mqj	峋
mqjg	峋
mqjh	刿
mqk	岣
mqkg	岣
mqt	峁
mqtb	峁
mqu	岁
mqv	峥
mqvh	峥
mr	冈
mr	网
mrc	贩
mrcy	贩
mrd	崤
mrde	崤
mri	冈
mrj	刚
mrjh	刚
mrq	嵬
mrqc	嵬
mrr	网
mrri	网
ms	赙
ms	岢
msf	赙
msfy	赙
msk	岢
mskf	岢
msv	崾
msvg	崾
msw	崧
mswc	崧
mt	败
mt	峰
mta	账
mtay	账
mtd	峰
mtdh	峰
mtdj	峤
mtk	赂
mtkg	赂
mtn	屹
mtnn	屹
mtp	贬
mtpy	贬
mtr	峨
mtry	峨
mtu	嵊
mtux	嵊
mtv	巍
mtvc	巍
mty	败
mu	赠
mu	赚
mua	嵯
muag	嵯
muj	嶂
mujh	嶂
muk	赔
mukg	赔
mul	赠
mulj	赠
muv	赚
muvw	赚
mux	嵫
muxx	嵫
muy	罔
muyn	罔
mw	内
mw	岭
mwf	赊
mwfi	赊
mwg	嵛
mwgj	嵛
mwgu	嶝
mwi	内
mwr	岚
mwru	岚
mww	肉
mwwi	肉
mwwk	峪
mwy	崔
mwyc	岭
mwyf	崔
mwyn	岑
mx	幽
mx	嶷
mxt	嶷
mxth	嶷
mxx	幽
mxxi	幽
my	丹
my	彤
myb	崞
mybg	崞
myd	丹
mye	彤
myet	彤
mym	嵩
mymk	嵩
myn	赅
mynw	赅
n	民
n	已
na	异
na	惜
nae	展
naei	展
nag	惬
nagd	惬
naj	羿
naj	异
najg	惜
nal	懵
nalh	懵
nan	屉
nanv	屉
nar	怄
nary	怄
nat	懂
natf	懂
natn	愍
nav	民
naw	殿
nawc	殿
nawe	臀
nay	慌
nayk	慌
nb	敢
nb	屈
nbb	孱
nbbb	孱
nbc	慑
nbcc	慑
nbm	屈
nbmk	屈
nbs	屙
nbsk	屙
nbt	憨
nbtn	憨
nbty	敢
nc	怪
nc	惨
ncd	惨
ncde	惨
ncf	怪
ncfg	怪
ncg	怿
ncgh	怿
nck	怡
nckg	怡
ncw	悛
ncwt	悛
nd	居
nd	怀
nda	惰
ndae	惰
ndd	恹
ndd	居
nddy	恹
ndg	怙
ndgn	憾
ndh	怀
ndhy	怀
ndj	剧
ndjh	剧
ndm	怖
ndmh	怖
ndn	忧
ndny	忧
ndo	恢
ndoy	恢
ne	尾
nev	尾
nf	导
nf	层
nfa	愤
nfam	愤
nfc	层
nfce	恸
nfci	层
nfcy	怯
nfcy	忮
nfd	懦
nfdj	懦
nff	恃
nffy	恃
nfh	慎
nfhw	慎
nfi	慰
nfif	尉
nfin	慰
nfio	熨
nfp	迅
nfpb	悖
nfpk	迅
nfq	怃
nfqn	怃
nft	屠
nftj	屠
nfu	悻
nfu	导
nfuf	悻
nfy	忖
ng	那
ng	情
ngb	那
ngbh	那
ngc	屋
ngcf	屋
ngd	刁
nge	情
ngeg	情
ngh	怔
nghg	怔
ngj	恒
ngjg	恒
ngk	司
ngkd	司
ngkg	悟
ngu	怦
nguf	怦
ngx	愫
ngxi	愫
nh	收
nh	眉
nhd	眉
nhdd	悱
nhe	胥
nhef	胥
nhf	遐
nhfp	遐
nhg	丑
nhgg	丑
nhi	疋
nhj	蛋
nhjh	悼
nhju	蛋
nhq	鹛
nhqg	鹛
nht	收
nhty	收
nhw	惧
nhwy	惧
nhy	疏
nhyk	疏
ni	尿
ni	悄
nie	悄
nied	屑
nieg	悄
nig	恍
nigq	恍
nii	尿
nim	惝
nimk	惝
nit	犀
nitg	犀
nj	慢
nj	悍
njc	悭
njcf	悭
njf	悍
njfg	悝
njfh	悍
njg	怛
njgg	怛
njl	愠
njlc	慢
njlg	愠
njq	惕
njqr	惕
njt	惺
njtg	惺
njy	憬
njyi	憬
nk	避
nk	壁
nkc	悒
nkcn	悒
nkh	忡
nkhh	忡
nkhm	愦
nkk	愕
nkkn	愕
nku	臂
nkue	襞
nkue	臂
nkuf	壁
nkuh	辟
nkup	避
nkuq	鐾
nkur	擘
nkus	檗
nkuv	劈
nkuv	嬖
nkuy	璧
nkuy	譬
nkuy	甓
nl	惭
nl	翼
nla	翼
nlaw	翼
nlr	惭
nlrh	惭
nls	悃
nlsy	悃
nly	愣
nlyt	愣
nm	届
nm	刷
nmd	惴
nmd	届
nmdj	惴
nmdy	怏
nmf	惆
nmfk	惆
nmg	恫
nmgk	恫
nmh	刷
nmhj	刷
nmj	恻
nmjh	恻
nmn	恺
nmnn	恺
nmu	惘
nmun	惘
nn	已
nn	己
nna	巽
nnaw	巽
nnd	毋
nnde	毋
nng	己
nngn	巳
nngn	己
nngt	尸
nnh	书
nnhg	忸
nnhy	书
nnk	局
nnkd	局
nnl	乙
nnll	乙
nnn	忆
nnnn	已
nnu	忌
nnv	乜
nnw	快
nnwy	快
nnx	怩
nnxn	怩
nny	羽
nnyg	羽
no	屡
no	屎
noh	惦
nohk	惦
noi	屎
nov	慷
novd	屡
novh	慵
novi	慷
np	忱
np	惋
npl	恽
nplh	恽
npq	惋
npqb	惋
npqn	忱
nq	懈
nq	惚
nqe	懈
nqeg	懈
nqj	恂
nqjg	恂
nqr	惚
nqrn	惚
nr	怕
nr	愧
nrg	惶
nrg	怕
nrgg	惶
nrh	忻
nrn	忾
nrq	愧
nrqc	愧
ns	懒
ns	怵
nsk	悚
nskg	悚
nskm	懒
nss	憷
nssh	憷
nsy	怵
nsyy	怵
nt	改
nt	性
nta	怅
ntay	怅
ntb	悸
ntbg	悸
ntc	发
ntcy	发
ntd	恬
ntdg	恬
nte	必
ntf	忏
ntfc	屐
ntfh	忤
ntfh	忏
ntg	性
ntgg	性
nth	屣
nthf	怍
nthh	屣
ntj	虱
ntji	虱
ntjt	愎
ntk	属
ntkg	恪
ntky	属
ntl	恤
ntlg	恤
ntm	懊
ntmd	懊
nto	愀
ntov	屦
ntoy	愀
ntt	履
nttt	履
ntx	悔
ntxy	悔
nty	改
nu	习
nu	飞
nua	屏
nuak	屏
nud	买
nud	习
nudu	买
nuf	翌
nui	飞
nuj	惮
nujf	憧
nujf	惮
nuk	悦
nukq	悦
nul	憎
nulj	憎
nuu	羼
nuuu	羼
nuv	慊
nuvw	慊
nux	悌
nuxt	悌
nuy	悯
nuyy	悯
nv	恨
nv	尻
nva	慨
nvaq	慨
nvk	怊
nvkg	怊
nvt	忉
nvv	尻
nvy	恨
nw	恰
nw	怜
nwb	怆
nwbn	怆
nwc	忪
nwcy	忪
nwe	戮
nwea	戮
nweg	鹨
nwg	愉
nwgj	愉
nwgk	恰
nwy	惟
nwya	戳
nwyc	怜
nwyf	翟
nwyg	惟
nwyo	憔
nx	尼
nx	惯
nxj	怫
nxjh	怫
nxm	惯
nxmy	惯
nxv	尼
nxx	屁
nxxv	屁
ny	心
ny	惊
nyh	忭
nyhy	忄
nyhy	忭
nyi	尺
nyiy	惊
nyj	昼
nyjg	昼
nyk	咫
nykw	咫
nyl	懔
nyli	懔
nyn	忙
nynn	忙
nyny	心
nyp	迟
nypi	迟
nyr	恼
nyrb	恼
nyu	尽
nyuu	尽
nyw	翠
nywf	悴
nywf	翠
nywy	以
o	为
o	火
oa	席
oa	度
oac	度
oaci	度
oak	廑
oakg	廑
oam	席
oamh	席
oan	炬
oang	炬
oanw	炼
oany	庹
oao	庶
oaog	鹧
oaoi	庶
oaop	遮
oat	烧
oatq	烧
oaw	粪
oawu	粪
oawy	烘
ob	籽
ob	邝
obg	籽
obh	邺
obh	邝
obx	鬯
obxb	鬯
oc	序
oc	粑
oca	烃
ocag	烃
ocd	糁
ocde	糁
ocn	粑
ocnh	序
ocns	糅
od	类
od	庆
ode	糊
odeg	煳
odeg	糊
odg	炻
odgq	粝
odi	庆
odj	庵
odjn	庵
odm	烦
odmy	烦
odu	燎
odu	类
odui	燎
odx	庞
odxy	庞
oe	粗
oe	庾
oeg	粗
oegg	粗
oel	爝
oelf	爝
oew	庾
oewi	庾
of	庄
of	烤
ofc	庋
ofci	庋
ofd	糯
ofd	庄
ofdj	糯
ofg	灶
ofn	炜
ofnh	炜
ofq	庑
ofqv	庑
ofs	煤
ofsy	煤
oft	烤
oftn	烤
og	精
og	糟
ogb	炖
ogbn	炖
oge	精
ogeg	精
ogj	粳
ogjr	粳
ogk	焐
ogkg	焐
ogm	炳
ogmj	糟
ogmw	炳
ogq	廒
ogqt	廒
oh	业
oh	粘
ohh	业
ohhg	业
ohj	焯
ohjh	焯
ohk	店
ohkd	店
ohkg	粘
oi	应
oi	炒
oid	黻
oidy	黻
oig	应
oigd	应
ois	黼
oisy	黼
oit	炒
oitt	炒
oiu	黹
oj	烛
oj	爆
oja	爆
ojai	爆
ojf	焊
ojff	廛
ojfh	焊
ojl	熳
ojlc	熳
oju	煜
ojug	煜
ojy	烛
ok	燥
ok	炽
okk	燥
okks	燥
okw	炽
okwy	炽
ol	库
ol	烟
old	烟
oldy	烟
olg	煨
olge	煨
olk	库
om	灿
om	庙
omd	庙
omh	籼
omh	灿
omk	炯
omkg	炯
on	断
on	廖
onh	糈
onhe	糈
onr	炀
onrg	熠
onrh	断
onrt	炀
ont	废
onty	废
onw	炔
onwe	廖
onwy	炔
ony	烬
onyu	烬
oo	炎
oo	糖
oob	郯
oobh	郯
ooj	剡
oojh	剡
ooo	火
oooo	火
ooou	焱
oou	炎
oov	糖
oovi	糠
oovk	糖
op	迷
op	熔
opf	烷
opfi	粽
opfq	烷
opg	煊
opgg	煊
opi	迷
opw	熔
opwk	熔
oq	底
oq	炮
oqa	底
oqay	底
oqd	燃
oqdo	燃
oqe	焰
oqeg	廨
oqeg	焰
oqg	粼
oqgb	粼
oqgp	遴
oqm	焕
oqmd	焕
oqn	炮
oqnn	炮
oqnv	庖
oqw	炊
oqwy	炊
oqy	灼
oqyl	熘
oqyy	灼
or	粕
or	煌
ord	烯
ordh	烯
org	煌
org	粕
orgg	煌
ort	庳
ortf	庳
os	床
os	灯
osg	粞
osh	灯
osi	床
oss	麻
ossc	魔
ossc	麽
ossd	磨
ossd	靡
osse	麾
ossi	縻
ossi	麻
osso	糜
ossr	摩
ot	庭
ot	炸
otd	烽
otdh	烽
otf	糙
otfp	庭
otfp	糙
oth	炸
othc	煅
othd	糗
othf	炸
othj	糌
othn	熄
otk	烙
otkg	烙
otm	燠
otmd	燠
otn	烁
otni	烁
oto	燔
otol	燔
otu	烀
otuf	烀
oty	敉
ou	粒
ou	烂
oud	烂
oudg	烂
oue	燧
ouep	燧
ouf	料
oufb	凿
oufh	料
oug	糕
oug	粒
ougo	糕
ouh	烊
ouk	庠
oukg	焙
oun	焖
ouny	焖
ouv	廉
ouvw	廉
oux	糍
ouxx	糍
ov	数
ov	唐
ove	庸
oveh	庸
ovf	娄
ovh	唐
ovhk	唐
ovi	康
ovii	康
ovp	煺
ovpy	煺
ovty	数
ovw	庚
ovwi	庚
ovwm	赓
ow	府
ow	鹰
owb	炝
owbn	炝
owf	腐
owfc	烩
owfi	府
owfw	腐
own	糇
ownd	糇
ows	庥
owsi	庥
owv	粉
owvt	粉
oww	座
owwe	膺
owwf	座
owwg	鹰
owx	烨
owxf	烨
owy	焓
owyk	焓
ox	鹿
ox	麟
oxk	糨
oxkj	糨
oxv	庀
oxx	庇
oxxf	麝
oxxg	麟
oxxg	麈
oxxo	麋
oxxq	鏖
oxxt	麇
oxxv	鹿
oxxv	庇
oxxw	麒
oxxw	麂
oy	广
oy	米
oyb	廓
oybb	廓
oyg	炷
oygg	炷
oygt	广
oyl	廪
oyli	廪
oyn	炉
oyna	煸
oyne	庐
oynn	煽
oynt	炉
oyt	米
oyty	米
oyu	熵
oyuk	熵
oyv	粮
oyvb	廊
oyvy	粮
oyw	炕
oywf	粹
oywn	炕
oyx	炫
oyxy	炫
oyy	灬
oyyy	灬
p	这
p	之
pa	赛
pa	塞
pah	宦
pahh	宦
paj	寞
pajd	寞
pam	宽
pamq	宽
paw	寒
pawe	褰
pawf	塞
pawg	骞
pawh	蹇
pawm	赛
pawr	搴
paws	寨
pawu	寒
pawy	謇
pb	字
pbf	字
pd	害
pd	寡
pdc	宏
pdcu	宏
pde	寡
pdef	宥
pdev	寡
pdf	宕
pdfe	宸
pdh	豁
pdhj	割
pdhk	害
pdhk	豁
pds	寄
pdsk	寄
pdu	寮
pdui	寮
pdx	宠
pdxy	宠
pe	农
pe	宜
peg	宜
pegf	宜
pei	农
pf	守
pf	冠
pfi	宗
pfiu	宗
pfq	完
pfqb	完
pfqc	寇
pfqf	冠
pfu	守
pg	家
pg	定
pgc	室
pgcf	室
pge	冢
pgeu	家
pgey	冢
pgf	宇
pgfj	宇
pgh	定
pghu	定
pgj	宣
pgjg	宣
pgk	富
pgkl	富
pgm	寅
pgmw	寅
pgn	写
pgng	写
pgy	宝
pgyu	宝
ph	寂
phi	寂
phic	寂
pi	宵
pie	宵
pief	宵
pj	审
pj	宴
pjd	幂
pjdh	幂
pjh	审
pjhj	审
pjm	寓
pjmy	寓
pju	冥
pjuu	冥
pjv	宴
pjvf	宴
pk	宫
pkk	宫
pkkf	宫
pl	军
pl	寰
plb	郓
plbh	郓
plby	皲
plg	寰
plge	寰
plj	军
pm	宙
pmf	宙
pn	官
pn	密
pne	甯
pnej	甯
pnf	官
pnp	逭
pnpd	逭
pnt	密
pntj	蜜
pntm	密
pntr	宓
pnw	寥
pnwe	寥
pny	廴
po	灾
pou	灾
pp	之
ppp	之
pppp	之
pq	宛
pq	冤
pqb	剜
pqbb	宛
pqbj	剜
pqk	冤
pqky	冤
pqq	鸩
pqqg	鸩
pr	宾
prw	宾
prwu	宾
ps	宁
ps	宋
psj	宁
psu	宋
pt	客
pt	额
pta	宅
ptab	宅
ptf	宪
ptfq	宪
ptg	牢
ptgj	牢
ptk	额
ptkf	客
ptkm	额
pu	实
pu	被
pua	褡
puak	褡
pub	被
puby	被
puc	衩
pucc	裰
pucy	衩
pud	褥
pudf	褥
pudu	实
pue	衫
puet	衫
puf	褚
pufh	褂
pufj	襦
pufj	褚
pufu	寐
pufy	衬
pug	袜
puge	裱
pugk	寤
pugs	袜
puh	补
puhy	补
pui	裆
puiv	裆
puj	宰
pujg	袒
pujl	褴
pujn	褐
pujr	裼
pujs	裸
puk	裎
pukg	裎
pul	裢
pulp	裢
pum	袖
pumg	袖
pumw	衲
pun	袂
pund	裾
punr	褶
punw	袂
puo	裤
puol	裤
puov	褛
puq	袍
puqn	袍
pur	裨
purf	裨
purw	褫
pus	襟
pusi	襟
pusr	襻
put	袄
putd	袄
putf	衽
putk	袼
puu	袢
puue	褙
puug	袢
puuj	裥
puv	初
puvc	寝
puvk	裙
puvp	褪
puvt	初
puvy	裉
puw	裕
puwd	袱
puwg	裣
puwk	袷
puwk	裕
puwn	衿
puws	褓
pux	襁
puxj	襁
puy	褊
puya	褊
puyy	衤
pv	安
pv	案
pvb	宄
pvf	安
pvs	案
pvsu	案
pw	空
pw	察
pwa	穿
pwaf	空
pwan	窍
pwat	穿
pwav	窃
pwb	冗
pwbg	窿
pwd	突
pwdj	宿
pwdu	突
pwe	穷
pwer	穷
pwf	罕
pwfd	窦
pwfi	察
pwfj	罕
pwg	窥
pwgf	窒
pwgn	窀
pwgq	窥
pwj	窠
pwjs	窠
pwk	窝
pwkh	窜
pwkw	窝
pwm	帘
pwmh	帘
pwn	窟
pwnm	窟
pwo	窭
pwov	窭
pwq	窕
pwqi	窕
pwqu	穸
pwr	窳
pwry	窳
pwt	窗
pwtb	窑
pwtf	窄
pwtk	窖
pwtp	窆
pwtq	窗
pwu	穴
pwuj	窨
pwup	邃
pwv	究
pwvb	究
pwvk	窘
pww	容
pwwj	窬
pwwk	容
pwx	穹
pwxb	穹
pwxe	窈
pwy	鹤
pwyg	鹤
px	它
pxb	它
py	社
py	礼
pyb	祁
pybh	祁
pyd	祷
pydd	禊
pydf	祷
pydg	祜
pydw	祺
pydy	祓
pye	祖
pyeg	祖
pyf	禧
pyfc	祛
pyfg	社
pyfk	禧
pyg	福
pygd	祆
pygl	福
pyh	祯
pyhg	祉
pyhm	祯
pyj	神
pyjh	神
pyk	祝
pykq	祝
pykw	祸
pym	视
pymq	视
pyn	冖
pynk	祠
pynn	礼
pynn	祀
pyny	辶
pyq	祢
pyqi	祧
pyqi	祢
pyqy	祗
pyr	祈
pyrh	祈
pyt	祚
pytf	祚
pyu	祥
pyuf	禅
pyuh	祥
pyuo	禚
pyv	禄
pyvi	禄
pyy	禳
pyye	禳
pyyn	宀
pyyy	礻
q	我
q	金
qa	氏
qa	昏
qad	锘
qadk	锘
qah	铘
qahb	铘
qaj	错
qajd	镆
qajf	昏
qajg	错
qak	钷
qakg	钷
qal	锚
qalg	锚
qan	钺
qang	钜
qann	钺
qany	铽
qap	铹
qape	铹
qat	铙
qatq	铙
qav	氏
qaw	镬
qawc	镬
qay	邸
qayb	邸
qayg	鸱
qayi	氐
qb	迎
qb	怨
qbc	镊
qbcc	镊
qbg	铒
qbh	钌
qbhf	眢
qbl	锰
qblg	锰
qbn	怨
qbnu	怨
qbp	迎
qbpk	迎
qbq	鸳
qbqg	鸳
qbs	锕
qbsk	锕
qby	铍
qc	色
qc	勾
qcb	色
qcg	铎
qcgh	铎
qci	勾
qcn	钯
qcy	钗
qcyy	钗
qd	然
qd	危
qdb	危
qdbb	危
qdc	钹
qdcy	钹
qde	铕
qdeg	铕
qdf	锛
qdfa	锛
qdg	钴
qdh	锲
qdhd	锲
qdhy	钚
qdm	钸
qdmh	钸
qdn	铖
qdnn	铖
qdo	然
qdou	然
qdt	铸
qdtf	铸
qdu	镣
qdui	镣
qduw	镢
qdw	詹
qdwy	詹
qdy	钛
qdyy	钛
qe	角
qe	解
qef	锊
qefy	锊
qeg	钥
qegc	锾
qege	锄
qeh	锼
qehc	锼
qei	觥
qeiq	觥
qej	触
qej	角
qejy	触
qen	觖
qenw	觖
qer	觚
qery	觚
qes	觫
qesk	觫
qet	钐
qetr	觞
qeu	斛
qeuf	觯
qeuf	斛
qev	解
qevg	解
qevj	蟹
qevp	邂
qf	针
qf	镇
qfg	钳
qfg	钍
qfh	镇
qfh	针
qfhw	镇
qfl	镭
qflg	镭
qft	锗
qftj	锗
qftn	铐
qftx	铑
qg	钱
qg	印
qga	鲽
qgac	鹱
qgae	鳓
qgas	鲽
qgay	钱
qgb	印
qgbc	鲰
qgbh	印
qgbn	钝
qgc	鲐
qgcj	鳋
qgck	鲐
qgd	鸟
qgde	鲔
qgdj	鲕
qgdw	鳜
qgdy	鱿
qgdy	鲅
qge	鲵
qgeb	鳐
qgeg	锖
qgeq	鲵
qgf	鱼
qgff	鲑
qgfj	鳍
qgfk	鲒
qgfm	鲼
qgft	鲮
qgfv	鳕
qgg	鲠
qgge	鲭
qggf	鲆
qggr	鲠
qggy	鲡
qgh	舛
qghd	鲱
qghg	钲
qghk	鲇
qghn	钙
qghn	鲈
qgj	鲁
qgjc	鳗
qgjf	鲤
qgjf	鲥
qgjf	鲣
qgjf	鲁
qgjj	鲳
qgjn	鳎
qgjx	鲲
qgk	鳄
qgkh	镉
qgkl	匐
qgkn	鳄
qgl	鳃
qgld	鲴
qgli	鳏
qgln	鳃
qglp	鲢
qgm	鲷
qgmk	鲷
qgmu	鳢
qgn	鲺
qgnj	鲺
qgo	鳞
qgog	鳞
qgoh	鳙
qgp	鸵
qgpq	鲩
qgpx	鸵
qgq	鲍
qgqn	鲍
qgr	鳇
qgrg	鳇
qgs	桀
qgsi	鳔
qgsu	桀
qgt	稣
qgti	鲧
qgto	鳅
qgts	鲦
qgtt	鳆
qgty	稣
qgu	鲜
qgud	铗
qguf	鳟
qguh	鲜
qguk	鳝
qgur	鲛
qgus	铼
qgv	鲫
qgvb	鲫
qgvf	鲟
qgvl	鲻
qgw	鲶
qgwf	鲋
qgwn	鲶
qgy	鲸
qgya	鳊
qgyi	鲸
qgyj	鲚
qgyt	鲂
qgyy	钰
qh	外
qh	钻
qhg	钼
qhk	钻
qhkg	钻
qhy	钋
qhy	外
qi	尔
qi	逃
qie	销
qieg	销
qif	鼗
qifc	鼗
qig	玺
qigy	玺
qii	兆
qim	锁
qimy	锁
qin	铴
qinr	铴
qip	逃
qipf	镗
qipi	迩
qipi	逃
qit	钞
qitt	钞
qiu	尔
qiv	铛
qivg	铛
qj	旬
qj	锡
qjb	郇
qjbh	郇
qjc	铿
qjcf	铿
qjd	旬
qjf	锂
qjfg	锂
qjg	锝
qjgf	锝
qjgg	钽
qjh	钊
qjl	镘
qjlc	镘
qjn	龟
qjnb	龟
qjq	锡
qjqr	锡
qjs	锞
qjsy	锞
qjx	锟
qjxx	锟
qk	名
qk	钟
qkd	句
qke	象
qket	劬
qkeu	象
qkf	名
qkg	锃
qkgg	锃
qkh	钏
qkhh	钟
qkk	铝
qkkg	铝
qkkn	锷
qkm	锅
qkmh	铞
qkmw	锅
qkq	免
qkqb	免
qkqe	勉
qkqg	鸲
qkqp	逸
qkqq	够
qkqy	兔
ql	甸
ql	钾
qld	锢
qld	甸
qldg	锢
qldy	铟
qlg	钿
qlh	钾
qln	锶
qlny	锶
qlp	链
qlpy	链
qlq	锣
qlqj	镯
qlqy	锣
qlx	镙
qlxi	镙
qm	负
qm	铜
qmd	奂
qmdu	奂
qmg	铀
qmgk	铜
qmj	铡
qmjh	铡
qmk	岛
qmn	铠
qmnn	铠
qmr	钢
qmry	钢
qmu	负
qmw	钠
qmwy	钠
qmy	钡
qn	包
qn	饿
qna	饶
qnad	馍
qnag	馑
qnaq	饶
qnat	馓
qnb	饣
qnbg	饵
qnc	饴
qnck	饴
qnd	锯
qndg	锯
qne	馁
qnec	馊
qnev	馁
qnf	饽
qnfb	饽
qng	饯
qnga	饯
qnge	馕
qngn	饨
qnh	钮
qnhg	镅
qnhg	钮
qnj	蚀
qnjc	馒
qnjh	刨
qnjx	馄
qnjy	蚀
qnk	馈
qnkm	馈
qnn	钆
qnn	钇
qnnk	饲
qnnk	锔
qnnr	饧
qnnw	馔
qnp	馆
qnpn	馆
qnq	饮
qnqe	馅
qnql	馏
qnqn	饱
qnqu	馋
qnqw	饮
qnr	饭
qnrc	饭
qnrn	饩
qns	馇
qnsg	馇
qnt	饰
qntd	饫
qnte	饬
qntf	饪
qnth	饰
qntk	饷
qntt	铋
qnty	饿
qnu	饼
qnua	饼
qnug	馐
qnur	饺
qnv	包
qnw	饥
qnwn	饥
qnws	馀
qnx	铌
qnxn	铌
qo	炙
qo	镀
qoa	镀
qoac	镀
qoo	锬
qooy	锬
qou	镰
qou	炙
qoug	镤
qouw	镰
qov	镂
qovg	镂
qovh	镛
qox	镳
qoxo	镳
qoy	钬
qp	锭
qp	夤
qpg	夤
qpge	镓
qpgh	锭
qpgw	夤
qpr	镔
qprw	镔
qpv	铵
qpvg	铵
qpw	镲
qpwh	镩
qpwi	镲
qpx	铊
qpxn	铊
qq	多
qq	铭
qqc	钩
qqcn	铯
qqcy	钩
qqg	镥
qqgj	镥
qqi	铫
qqiy	铫
qqk	铭
qqkg	铭
qqq	金
qqqf	鑫
qqqq	金
qqr	锪
qqrn	锪
qqt	铆
qqtb	铆
qqu	钧
qqu	多
qqug	钧
qqv	铮
qqvh	铮
qqw	钦
qqwy	钦
qqy	钓
qqyl	镏
qqyy	钓
qr	勿
qr	忽
qrb	匈
qrbk	匈
qrc	钣
qrcy	钣
qre	勿
qrg	铂
qrj	刎
qrjh	刎
qrm	锦
qrmh	锦
qrn	忽
qrnu	忽
qrq	锨
qrqw	锨
qrs	铩
qrsy	铩
qry	匆
qryi	匆
qs	钉
qs	铺
qsf	镖
qsfi	镖
qsg	钵
qsgg	钵
qsh	钉
qsi	匍
qsj	镡
qsjh	镡
qsk	钶
qskg	钶
qsu	枭
qsy	铺
qt	儿
qt	猜
qta	猫
qtad	狨
qtaj	猎
qtal	猫
qtay	獾
qtb	犯
qtbh	卯
qtbi	狲
qtbl	猛
qtbn	犯
qtbt	锈
qtc	犸
qtcg	犸
qtcq	狁
qtcs	猱
qtct	狻
qtd	锋
qtde	猢
qtdh	锋
qtdi	獠
qtdk	猗
qtdw	獗
qtdy	犹
qte	狙
qteg	狙
qteq	猊
qtf	猿
qtfa	锤
qtfc	铥
qtfe	锸
qtfe	猿
qtfh	犴
qtfh	钎
qtfj	猪
qtfk	锆
qtfp	铤
qtfq	铣
qtfs	橥
qtfy	铢
qtg	铁
qtgd	狭
qtge	猜
qtgf	锺
qtgg	狂
qtgn	钅
qtgp	逛
qtgy	铁
qth	锻
qthc	锻
qths	镍
qtj	独
qtjf	狸
qtjg	猩
qtjh	狮
qtjj	猖
qtjs	猓
qtjy	独
qtk	铬
qtke	狷
qtkg	铬
qtl	猥
qtle	猬
qtle	猥
qtlh	狎
qtlq	猡
qtm	狈
qtme	猾
qtmy	狈
qtn	勹
qtn	儿
qtng	钨
qtng	狃
qtnh	猸
qtni	铄
qtny	夕
qto	狄
qtop	逖
qtot	犷
qtoy	锹
qtoy	狄
qtp	狞
qtpf	狩
qtps	狞
qtq	狗
qtqg	獬
qtqh	狰
qtqk	狗
qtqn	狍
qtr	狐
qtry	锇
qtry	狐
qts	獭
qtsg	猹
qtsm	獭
qtt	猁
qttj	猁
qtto	獯
qttt	犭
qtu	狡
qtuj	獐
qtuq	獍
qtur	狡
qtv	狠
qtvb	卿
qtvn	犰
qtvy	狠
qtw	猴
qtwc	狯
qtwd	猴
qtwg	猃
qtwk	猞
qtws	狳
qtx	猕
qtxf	狴
qtxi	猕
qtxj	狒
qty	狱
qtyd	狱
qtyf	猝
qtyg	狺
qtyv	狼
qu	匀
qu	镜
qud	匀
quf	钭
qufh	钭
qug	镁
quga	锎
qugb	锩
qugd	镁
quh	锌
quj	镜
qujg	锏
qujn	镱
qujq	镜
quk	锐
qukg	锫
qukq	锐
qun	钔
quo	镨
quoj	镨
quq	锵
quqf	锵
qur	铰
qury	铰
qus	镧
qusl	镧
qut	铲
qutt	铲
quw	镒
quwl	镒
qux	锑
quxt	锑
qv	争
qv	急
qvb	邹
qvbh	邹
qvby	皱
qvf	刍
qvg	钕
qvgp	键
qvh	争
qvhj	争
qvk	铷
qvkg	铷
qvl	锱
qvlg	锱
qvn	急
qvnu	急
qvp	锓
qvpc	锓
qvt	煞
qvto	煞
qvw	雏
qvwy	雏
qvy	银
qw	欠
qw	铃
qwb	凫
qwg	镫
qwgg	铨
qwgk	铪
qwgr	镎
qwgu	镫
qwk	铅
qwkg	铅
qwu	欠
qww	锉
qwwf	锉
qwx	铧
qwxf	铧
qwy	锥
qwyb	镌
qwyc	铃
qwyg	锥
qwyn	钤
qwyv	飧
qwyy	钒
qx	锴
qx	镄
qxj	镄
qxjm	镄
qxk	镪
qxkj	镪
qxxr	锴
qy	久
qy	留
qyb	镦
qybt	镦
qyc	铳
qyck	锍
qycq	铳
qyd	訇
qye	铱
qyeu	袅
qyey	锿
qyey	铱
qyi	勺
qyi	久
qyk	镶
qyke	镶
qym	镐
qymh	铈
qymk	镐
qyo	灸
qyou	灸
qyt	钫
qytb	孵
qytd	镞
qyth	镟
qyty	卵
qyu	镑
qyud	镝
qyuy	镑
qyv	贸
qyvl	留
qyvm	贸
qyvp	遛
qyvy	锒
qyw	钪
qywn	钪
qyx	铉
qyxy	铉
r	的
r	白
ra	找
ra	摸
raa	拭
raay	拭
rab	皂
rae	撒
raet	撒
rag	扛
raj	措
rajd	摸
rajg	措
rajv	揠
ral	描
ralg	描
ran	拒
rang	拒
rans	揲
ranw	拣
rap	捞
rape	捞
rar	抠
rary	抠
rat	挠
ratq	挠
raw	拱
rawk	搭
raws	搽
rawy	拱
ray	找
rb	报
rb	扔
rbb	揶
rbbh	揶
rbc	摄
rbcc	摄
rbcy	报
rbe	氖
rbh	邱
rbi	拯
rbig	拯
rbk	凶
rbm	拙
rbmh	拙
rbt	扔
rby	披
rc	反
rc	把
rca	氢
rcad	氢
rcah	拚
rcc	掇
rccc	掇
rccs	搡
rcd	掺
rcde	掺
rce	捅
rceh	捅
rcg	择
rcgh	择
rci	反
rck	抬
rckg	抬
rcn	把
rcnh	抒
rcns	揉
rcp	返
rcpi	返
rct	挨
rctd	挨
rcw	摊
rcwy	摊
rcy	瓜
rcyg	瓞
rcyi	瓜
rcyj	搔
rd	拓
rd	拜
rdb	扼
rdbn	扼
rdc	拔
rdcb	郄
rdcy	拔
rde	肴
rdef	肴
rdf	挎
rdfe	振
rdff	捱
rdfh	拜
rdfi	捺
rdfj	皋
rdfn	翱
rdfn	挎
rdg	撼
rdg	拓
rdgn	撼
rdj	掩
rdjn	掩
rdm	希
rdmb	郗
rdmh	希
rdmw	欷
rdmy	颀
rdn	扰
rdny	扰
rdp	挞
rdpy	挞
rdq	氪
rdqv	氪
rds	掎
rdsk	掎
rdu	撩
rdui	撩
rduw	撅
rdw	捧
rdwd	揍
rdwg	捧
rdwr	撕
rdx	拢
rdxy	拢
re	拥
re	摇
ree	撬
reee	撬
ref	捋
refy	捋
reg	援
regc	援
reh	搜
reh	拥
rehc	搜
rep	授
repc	授
ret	摇
retb	摇
rf	质
rf	挂
rfc	技
rfcy	技
rff	持
rffg	挂
rffy	持
rfh	盾
rfhd	盾
rfhp	遁
rfj	擀
rfjf	擀
rfk	拮
rfkg	拮
rfkm	撷
rfl	擂
rflg	擂
rfm	质
rfmi	质
rfn	抟
rfny	抟
rfp	挝
rfpy	挝
rfq	抚
rfqn	抚
rft	拷
rftn	拷
rfw	攉
rfwy	攉
rg	后
rg	皇
rgb	卮
rgbv	卮
rgd	掭
rgdn	掭
rge	氰
rged	氰
rgf	皇
rgg	撵
rggl	撵
rgh	扌
rghg	扌
rgk	捂
rgkd	后
rgke	攮
rgkg	捂
rgkp	逅
rgo	氩
rgod	氩
rgp	遑
rgpd	遑
rgs	抹
rgsy	抹
rgu	挟
rgud	挟
rguf	抨
rgv	捷
rgvh	捷
rgy	扶
rh	看
rh	爬
rhd	排
rhdd	排
rhe	掳
rhet	掳
rhf	看
rhg	扯
rhh	攫
rhhc	攫
rhj	掉
rhjh	掉
rhk	拈
rhkg	拈
rhn	摅
rhny	摅
rhy	扑
rhyc	爬
rhyi	爪
ri	泉
ri	搅
rie	捎
rieg	捎
rip	撑
ripq	搅
ripr	撑
rit	抄
ritt	抄
rity	撇
riu	泉
riv	挡
rivg	挡
rj	提
rj	担
rjb	撮
rjbc	撮
rjf	捏
rjfg	捏
rjfh	捍
rjg	担
rjgg	担
rjgh	提
rjh	刈
rjhh	抻
rjk	氘
rjl	氲
rjld	氲
rjn	拽
rjnt	拽
rjq	揭
rjqn	揭
rjt	揽
rjtq	揽
rk	扣
rk	操
rkb	揖
rkbg	揖
rkc	挹
rkcn	挹
rke	捐
rkeg	捐
rkej	捌
rket	拐
rkg	扣
rkh	捉
rkhy	捉
rkk	氚
rkks	操
rkm	损
rkmy	损
rl	押
rl	摆
rld	氤
rldi	氤
rldn	摁
rlf	摆
rlfc	摆
rlg	掴
rlge	擐
rlgy	掴
rlh	押
rls	捆
rlsy	捆
rlt	撂
rltk	撂
rlx	摞
rlxi	摞
rm	抽
rm	岳
rmd	揣
rmdj	揣
rmg	抽
rmh	帛
rmhj	帛
rmj	岳
rmk	氙
rmm	撄
rmmv	撄
rmn	皑
rmnn	皑
rmw	摧
rmwy	摧
rn	所
rn	扎
rna	抿
rnae	搌
rnan	抿
rnb	掘
rnbm	掘
rnbt	撖
rnd	据
rndg	据
rng	握
rngb	挪
rngf	握
rnh	扭
rnhg	扭
rnk	擗
rnku	擗
rnn	扎
rnnw	撰
rnr	扬
rnrg	摺
rnrh	所
rnrt	扬
rnt	拨
rnty	拨
rnu	摒
rnua	摒
rnw	抉
rnwy	擢
rnwy	抉
rny	拟
rnyw	拟
ro	扩
ro	搂
roa	摭
roao	摭
roh	掂
rohk	掂
roo	氮
rooi	氮
rot	扩
rov	搂
rovg	搂
rovk	搪
rovt	擞
rp	近
rp	探
rpd	迫
rpf	皖
rpfq	皖
rpg	揎
rpgg	揎
rpk	近
rpl	挥
rplh	挥
rpr	摈
rprw	摈
rps	拧
rpsh	拧
rpv	按
rpvd	氨
rpvg	按
rpw	控
rpwa	控
rpwh	撺
rpwi	擦
rpwn	挖
rpws	探
rq	换
rq	抱
rqa	抵
rqay	抵
rqb	抑
rqbh	抑
rqc	鬼
rqcc	魑
rqce	魈
rqcf	魅
rqcf	魁
rqci	鬼
rqcn	魍
rqcw	魉
rqcy	魃
rqe	掐
rqeg	掐
rqg	撸
rqgj	撸
rqi	挑
rqiy	挑
rqk	拘
rqkg	拘
rqkq	挽
rqku	搀
rqm	捣
rqmd	换
rqmh	捣
rqn	抱
rqnn	抱
rqnq	兜
rqo	掬
rqoy	掬
rqq	揿
rqqw	揿
rqt	掏
rqtb	掏
rqv	挣
rqvh	挣
rqw	欣
rqwy	欣
rqy	的
rqyy	的
rr	折
rr	魄
rrc	扳
rrcy	皈
rrcy	扳
rrg	拍
rrh	抓
rrh	折
rrhw	搋
rrhy	抓
rrj	蜇
rrju	蜇
rrk	哲
rrkf	哲
rrkh	踅
rrp	逝
rrpk	逝
rrq	掀
rrqc	魄
rrqw	掀
rrr	白
rrrr	白
rrt	捭
rrtf	捭
rru	爻
rry	拆
rryf	誓
rryy	拆
rs	打
rs	杀
rsa	弑
rsay	弑
rsf	搏
rsfy	搏
rsh	打
rsj	刹
rsjg	揸
rsjh	刹
rsu	杀
rsy	捕
rt	手
rt	挺
rta	托
rtan	托
rtb	拖
rtbn	拖
rtd	括
rtdg	括
rtdj	挢
rte	氕
rtf	卑
rtfa	捶
rtfb	郫
rtfe	插
rtfg	鹎
rtfh	扦
rtfj	卑
rtfk	皓
rtfm	攒
rtfp	挺
rtg	气
rtgh	手
rtgn	气
rth	丘
rthg	丘
rthi	攥
rthj	擤
rto	播
rtol	皤
rtol	播
rtoy	揪
rtr	乒
rtt	斤
rtth	斤
rtu	搬
rtuc	搬
rtui	氡
ru	拉
ru	接
rua	拼
ruag	搓
ruah	拼
rub	搠
rube	搠
rud	拦
rudb	掷
rudg	拦
ruf	抖
rufh	抖
rug	拌
rug	拉
rugh	拌
ruj	撞
rujf	掸
rujf	撞
rujg	揞
ruk	氧
rukg	掊
run	扪
rur	皎
rury	皎
rus	撙
rusf	撙
rut	搁
rutk	搁
ruv	接
ruvg	接
ruvw	搛
rv	扫
rv	热
rve	抛
rvet	抛
rvg	扫
rvi	氯
rvii	氯
rvk	招
rvkg	招
rvn	殷
rvnc	殷
rvq	拶
rvqy	拶
rvt	捃
rvtk	捃
rvy	执
rvye	势
rvyf	垫
rvyg	鸷
rvyi	絷
rvyj	蛰
rvym	贽
rvyo	热
rvyr	挚
rvyy	执
rw	兵
rw	推
rwb	抢
rwbn	抢
rwc	投
rwcy	投
rwf	拊
rwfy	拊
rwg	捡
rwgd	揆
rwgg	拴
rwgg	捡
rwgj	揄
rwgk	拾
rwgr	搿
rwu	兵
rwv	氛
rwve	氛
rwvr	掰
rwvt	扮
rww	挫
rwwf	挫
rwx	抡
rwxn	抡
rwy	扒
rwyb	携
rwyc	擒
rwyc	拎
rwyg	推
rwyn	捻
rx	指
rx	批
rxe	拗
rxet	拗
rxey	掾
rxj	拂
rxjg	指
rxjh	拂
rxjk	氟
rxm	掼
rxmy	掼
rxu	搦
rxuu	搦
rxx	批
rxxn	批
rxxr	揩
rxy	拇
ry	搞
ry	摘
ryc	撤
ryct	撤
ryg	拄
rygg	拄
ryi	斥
ryiy	掠
ryj	挤
ryjh	挤
ryk	攘
ryke	攘
ryl	擅
rylg	擅
rym	搞
rymk	搞
ryn	护
rynd	捩
ryne	掮
rynt	护
rynw	氦
ryt	邀
rytp	邀
ryty	敫
ryu	乓
ryud	摘
ryw	抗
rywn	抗
rywy	掖
ryx	摔
ryxf	摔
ryxl	搐
s	要
s	木
sa	模
sa	横
saa	械
saah	械
sab	栉
sabh	栉
sag	杠
sagg	框
sah	榧
sahd	榧
sai	栋
saiy	栋
saj	模
sajd	模
sak	槿
sakg	槿
sam	横
samw	横
san	柜
sang	柜
sap	檬
sape	檬
saq	柩
saqy	柩
sar	枢
sary	枢
sat	桡
satq	桡
sb	李
sb	极
sbb	椰
sbbh	椰
sbc	楹
sbcl	楹
sbd	椭
sbde	椭
sbf	李
sby	极
sbyy	极
sc	权
sc	树
sce	桶
sceh	桶
scf	树
scfg	柽
scfy	树
scg	杩
scgg	杩
scn	杷
scnh	杼
scnk	橘
scnn	懋
scw	梭
scwt	梭
scy	杈
scy	权
scyy	杈
sd	顶
sd	棒
sde	枥
sdet	枥
sdg	枯
sdg	柘
sdgf	橱
sdh	杯
sdhd	楔
sdhi	槭
sdhy	杯
sdm	顶
sdmy	顶
sds	椅
sdsk	椅
sdt	梆
sdtb	梆
sdu	橛
sduw	橛
sdw	棋
sdwd	楱
sdwg	棒
sdwj	椿
sdwn	椹
sdwt	榛
sdwy	棋
sdx	栊
sdxy	栊
sdy	杖
sdyy	杖
se	杉
se	棚
seb	桴
sebg	桴
see	棚
seee	橇
seeg	棚
seg	桕
sek	枷
sekg	枷
set	杉
sf	票
sf	飘
sfb	鄄
sfbh	鄄
sfc	枝
sfcy	枝
sff	桂
sffg	桂
sffn	樗
sfg	杜
sfg	柑
sfgy	甄
sfh	杆
sfhg	植
sfhn	樾
sfi	标
sfij	剽
sfir	飘
sfiu	柰
sfiu	票
sfiy	瓢
sfiy	标
sfk	桔
sfkg	桔
sfl	檑
sflg	檑
sfm	楠
sfmf	楠
sfn	椟
sfnd	椟
sft	材
sftj	楮
sftn	栲
sftt	材
sftx	栳
sfu	樯
sfuk	樯
sfw	棱
sfwt	棱
sfy	村
sg	本
sg	西
sga	栈
sgag	醛
sgaj	醋
sgay	栈
sgb	酏
sgbn	酏
sgc	酸
sgcf	桎
sgct	酸
sgd	酉
sgd	本
sgde	醐
sgdg	酤
sgdl	醢
sgdy	酞
sge	酹
sgef	酹
sgf	酣
sgfb	酵
sgfc	酝
sgfg	酣
sgfh	酐
sgfy	酎
sgg	枉
sggt	酽
sggy	酾
sgh	丁
sghe	醵
sghg	西
sghy	甫
sgj	醒
sgjg	桓
sgjg	醒
sgjh	醍
sgjr	梗
sgjx	醌
sgk	梧
sgkg	酲
sgkg	梧
sgm	槽
sgmj	槽
sgmk	酮
sgmu	醴
sgmw	柄
sgn	配
sgne	醪
sgne	醑
sgnn	朽
sgnn	配
sgo	醚
sgog	桠
sgog	醭
sgok	醣
sgop	醚
sgp	酡
sgpx	酡
sgq	酌
sgqk	酩
sgqn	杌
sgqy	酌
sgr	酗
sgrb	酗
sgs	酊
sgsh	酊
sgt	酷
sgtf	酢
sgtk	酪
sgtk	酷
sgto	醺
sgtq	酰
sgtx	酶
sgty	酥
sgu	枰
sguf	枰
sguk	醅
sgw	酚
sgwo	醮
sgws	酴
sgwv	酚
sgx	酯
sgxj	酯
sgy	酬
sgyb	醇
sgyf	醉
sgyh	酬
sgyl	醯
sgyv	酿
sh	相
sh	想
shg	相
shi	椒
shic	椒
shj	棹
shjh	棹
shm	桢
shmy	桢
shn	想
shnt	栌
shnu	想
shy	朴
si	档
si	梢
sie	梢
sieg	梢
sig	榉
sigg	榉
sigq	桄
sii	桫
siit	桫
sip	樘
sipf	樘
sit	杪
sitt	杪
siv	档
sivg	档
sj	查
sj	覃
sjf	杳
sjg	查
sjgf	查
sjj	覃
sjn	榻
sjng	榻
sjs	棵
sjsy	棵
sjt	槛
sjtl	槛
sjtq	榄
sjx	棍
sjxx	棍
sk	可
sk	哥
skb	楫
skbg	楫
skd	束
skd	可
skf	杏
skg	枵
skgn	枵
skj	剌
skjh	剌
skk	榀
skkk	榀
skp	速
skpd	速
skq	赖
skqm	赖
sks	歌
sksk	哥
sksw	歌
skt	整
skth	整
skty	敕
skw	枳
skwy	枳
sl	柬
sl	楞
sld	柬
slh	柙
slq	椤
slqy	椤
sly	楞
slyt	楞
sm	贾
sm	刺
smg	柚
smgk	桐
smj	刺
smjh	刺
smm	樱
smmg	栅
smmv	樱
smn	桤
smnn	桤
smq	枧
smqn	枧
sms	棘
smsm	棘
smu	枣
smu	贾
smuu	枣
smw	枘
smwy	枘
sn	札
sn	杨
snb	橄
snbt	橄
snd	椐
sndg	椐
sng	栩
snh	楣
snhg	楣
sni	樨
snie	榍
snig	樨
snn	杞
snn	札
snr	杨
snrt	杨
so	杰
so	楼
sof	桩
sofg	桩
sou	粟
sou	杰
sov	楼
sovg	楼
sp	枕
sp	榕
spf	棕
spfi	棕
spg	楦
spgg	楦
spi	逋
spn	棺
spng	棺
spq	枕
spqn	枕
spr	槟
sprw	槟
sps	柠
spsh	柠
spv	桉
spvg	桉
spw	榨
spwf	榨
spwi	檫
spwk	榕
spwy	榷
spx	柁
spxn	柁
sq	构
sq	柳
sqa	柢
sqay	柢
sqc	构
sqcy	构
sqd	桅
sqdb	桅
sqdy	檐
sqe	桷
sqef	槲
sqeh	桷
sqg	橹
sqgj	橹
sqi	桃
sqiy	桃
sqk	橡
sqke	橡
sqkg	枸
sqt	柳
sqtb	柳
sqy	榴
sqyl	榴
sqyy	杓
sr	析
sr	板
src	板
srcy	板
srd	槔
srdf	槔
srg	柏
srgb	栀
srh	析
srm	棉
srmh	棉
srq	槐
srqc	槐
srr	攀
srrd	樊
srrf	皙
srrr	攀
sry	檄
sryt	檄
sryy	柝
ss	林
ss	梦
ssb	郴
ssbh	郴
sse	彬
sset	彬
ssf	禁
ssfi	禁
ssg	栖
ssj	楂
ssjg	楂
ssk	柯
sskg	柯
ssl	楝
sslg	楝
ssn	楚
ssnh	楚
sso	焚
ssou	焚
ssox	麓
ssq	梦
ssqu	梦
sss	森
ssss	木
sssu	森
ssu	栗
ssv	婪
ssvf	婪
ssw	梵
sswv	棼
sswy	梵
ssy	林
st	枚
st	桥
sta	枨
stay	枨
std	桥
stdg	栝
stdj	桥
stf	株
stfa	棰
stfh	杵
stfk	梏
stfp	梃
stfy	株
stg	桁
stgs	桁
sth	柞
sthc	椴
sthf	柞
stk	格
stkg	格
stm	榭
stmf	榭
stn	槌
stni	栎
stnp	槌
sto	楸
stoy	楸
stt	覆
sttt	覆
stx	梅
stxy	梅
sty	枚
su	样
su	校
sua	槎
suag	槎
sud	栏
sudg	栏
suh	梓
suh	样
suj	樟
sujh	樟
suk	榈
sukk	榈
sur	校
sury	校
sus	樽
susf	樽
susy	榇
sux	梯
suxt	梯
sv	根
sv	概
sva	概
svaq	概
svf	要
svg	楗
svgp	楗
svi	棣
sviy	棣
svo	棂
svoy	棂
svy	根
sw	机
sw	枪
swb	枪
swbn	枪
swc	松
swcy	松
swf	桧
swfc	桧
swg	检
swgg	栓
swgg	检
swgj	榆
swgu	橙
swn	机
swr	枫
swry	枫
sww	麴
swwo	麴
swwy	枞
swx	桦
swxf	桦
swy	椎
swyc	柃
swyc	檎
swyf	榫
swyg	椎
swyo	樵
sx	楷
sx	椽
sxe	椽
sxey	椽
sxx	橼
sxxe	橼
sxxn	枇
sxxr	楷
sy	术
sy	述
syb	椁
sybg	椁
syc	梳
syck	梳
syf	槠
syfj	槠
syg	柱
sygg	柱
syi	椋
syi	术
syiy	椋
syk	榱
syke	榱
syl	檀
sylg	檀
syli	檩
sym	柿
symh	柿
symk	槁
syn	核
synw	核
syp	述
sypi	述
syt	枋
syty	敷
syu	榜
syuy	榜
syv	榔
syvb	榔
syw	杭
sywn	杭
t	和
t	禾
ta	长
ta	彻
tab	筇
tabj	筇
tad	箬
tadk	箬
tag	筐
tagd	箧
tagf	筐
tah	篚
tahd	篚
tak	升
takf	笸
tam	簧
tamf	篝
tamw	簧
taq	簪
taqj	簪
tav	乇
tavt	彻
taw	筑
taww	筮
tawy	筑
tay	长
tayi	长
tb	秀
tb	季
tbf	季
tbp	透
tbpe	透
tbpv	迤
tbr	秀
tby	彼
tbyu	笈
tc	么
tc	私
tca	径
tcag	径
tcb	笆
tcg	笃
tcgf	笃
tck	笞
tckf	笞
tcu	么
tcy	私
td	知
td	辞
tda	矩
tdan	矩
tdas	榘
tdd	舌
tdf	甜
tdfg	甜
tdg	短
tdgk	箴
tdgn	舔
tdgu	短
tdh	逢
tdhp	逢
tdi	夭
tdj	乔
tdjh	刮
tdjj	乔
tdk	智
tdkg	知
tdkj	智
tdm	岙
tdmj	岙
tdn	乱
tdnj	稽
tdnm	嵇
tdnn	乱
tdp	适
tdpd	适
tdq	舐
tdqa	舐
tdqg	鸹
tdt	敌
tdtf	筹
tdtj	矫
tdtn	憩
tdtv	矮
tdty	敌
tdu	矢
tduh	辞
tdw	箕
tdwb	簸
tdwf	矬
tdwu	箕
tdwy	雉
tdx	笼
tdxh	矧
tdxy	笼
te	务
te	笔
teb	笔
tebg	稃
tee	稻
teeg	稻
teer	筋
teg	租
tegg	徂
tegg	租
tek	笳
tekf	笳
tep	笾
tepu	笾
ter	务
tet	徭
tetb	徭
tf	等
tf	街
tfa	垂
tfad	垂
tfb	缺
tfba	缸
tfbf	罅
tfbh	邾
tfbk	缶
tfbw	缺
tfby	罐
tfc	丢
tfcu	丢
tfd	壬
tfe	歃
tfew	歃
tff	竺
tffs	街
tffu	等
tffy	待
tfh	秆
tfhw	稹
tfhy	徒
tfi	朱
tfj	午
tfj	竿
tfk	千
tfkb	郜
tfkd	靠
tfkf	告
tfkg	鹄
tfkg	秸
tfkp	造
tfl	德
tfln	德
tfp	迁
tfpd	廷
tfpk	迕
tfpk	迁
tfq	先
tfqb	先
tfqm	赞
tfqp	选
tfqu	筠
tfs	籍
tfsj	籍
tft	箸
tftj	箸
tfu	乖
tfuk	穑
tfux	乖
tg	年
tg	生
tga	笺
tgaj	笄
tgau	笺
tgd	生
tge	箐
tgef	箐
tgf	竽
tgfj	竽
tgh	征
tghb	卸
tghf	眚
tghg	征
tghn	惩
tgi	失
tgj	重
tgj	年
tgjf	重
tgjn	穗
tgjr	筻
tgk	牛
tgks	衙
tgl	舞
tgle	甥
tglg	舞
tglo	熏
tgm	制
tgmj	制
tgmr	掣
tgmu	箦
tgp	迭
tgpi	迭
tgpk	逄
tgs	行
tgsh	行
tgsy	秣
tgu	秤
tguf	秤
tgus	徕
th	处
th	段
tha	算
thaj	算
thd	自
thdc	段
thdc	篡
thdd	徘
thdi	纂
thdu	臭
thf	乍
thff	乍
thfn	怎
thfp	迮
thg	片
thgc	版
thgd	牍
thgf	牌
thgn	片
thgs	牒
thgs	牖
thh	徙
thhs	衢
thhy	徙
thi	处
thj	昝
thjf	昝
thk	咎
thkf	咎
thl	鼻
thlf	鼾
thlg	齄
thlj	劓
thlj	鼻
thlk	齁
thlv	鼽
thn	息
thnp	延
thnu	息
ths	臬
thsu	臬
tht	竹
thth	竹
ti	秒
ti	稍
tie	稍
tief	筲
tieg	稍
tig	衍
tign	愆
tigs	衍
tim	徜
timk	徜
tir	箔
tirf	箔
tis	簿
tisf	簿
tit	秒
titt	秒
tj	得
tj	利
tjf	香
tjg	筛
tjgf	笪
tjgf	得
tjgh	筛
tjh	利
tjs	梨
tjsu	梨
tjsy	稞
tjt	复
tjtg	犁
tjtl	篮
tjtt	馥
tjtu	复
tk	各
tk	种
tkf	各
tkg	程
tkg	和
tkgg	程
tkh	种
tkhh	种
tkhm	篑
tkk	稆
tkkg	稆
tkm	禹
tkmy	禹
tkw	积
tkwy	雒
tkwy	积
tl	备
tl	血
tla	篾
tlaw	篾
tld	血
tlf	睾
tlf	备
tlff	睾
tlg	箅
tlgj	箅
tlk	徊
tlkg	徊
tln	惫
tlng	衄
tlnu	惫
tlo	粤
tlon	粤
tlq	囱
tlqi	囱
tlqu	箩
tlr	囟
tlri	囟
tlu	衅
tlug	衅
tlw	稷
tlwt	稷
tm	身
tm	躲
tmd	射
tmdf	射
tmdk	躺
tmdr	躯
tmds	躲
tmdt	身
tmdx	躬
tmdy	秧
tmf	笛
tmfk	稠
tmg	微
tmgk	筒
tmgt	徽
tmgt	徵
tmgt	微
tmh	币
tmhk	币
tmk	向
tmkd	向
tmo	奥
tmod	奥
tmq	秽
tmqb	笕
tmqy	秽
tn	乐
tn	追
tnb	乞
tnf	阜
tnfj	阜
tng	笥
tngk	笥
tni	乐
tnii	乐
tnn	乌
tnnb	邬
tnng	乌
tnnw	筷
tnp	追
tnpd	追
tnpv	迄
tnt	秘
tntt	秘
to	秋
to	翻
toc	释
tocg	释
tol	番
tolb	鄱
tolf	番
toln	翻
tom	釉
tomg	釉
ton	悉
tonr	簖
tonu	愁
tonu	悉
tov	篓
tovf	篓
tox	簏
toxx	簏
toy	秋
tp	乏
tp	管
tpg	稼
tpge	稼
tpn	管
tpnf	管
tpq	箢
tpqb	箢
tpu	乏
tpw	箜
tpwa	箜
tq	稳
tq	称
tqd	衡
tqds	衡
tqg	衔
tqgs	衔
tqi	称
tqiy	称
tqj	徇
tqjg	徇
tqk	笱
tqkf	笱
tqq	移
tqqy	移
tqr	笏
tqrr	笏
tqt	黎
tqti	黎
tqto	黧
tqv	筝
tqvh	筝
tqvn	稳
tr	稀
tr	穆
tra	箍
trah	箍
trc	筢
trcb	筢
trcg	箨
trd	稀
trdh	稀
trf	循
trff	箝
trfh	循
trg	徨
trgf	篁
trgg	徨
trh	笊
trhw	篪
trhy	笊
tri	穆
trie	穆
trk	筘
trkf	筘
trn	鹅
trng	鹅
trny	我
trq	篼
trql	籀
trqq	篼
trt	稗
trtf	稗
try	徼
tryt	徼
ts	条
ts	策
tsg	笨
tsgf	笨
tsh	箱
tshf	箱
tsj	簟
tsjj	簟
tsk	籁
tskm	籁
tskw	簌
tsm	策
tsmb	策
tss	篥
tssu	篥
tsu	条
tsy	秫
tsyy	秫
tt	秩
tt	笑
ttd	笑
ttdp	篷
ttdu	笑
ttf	筅
ttfq	筅
ttg	御
ttgb	御
ttgf	笙
ttgy	攵
ttgy	秩
tth	筵
tthf	笮
tthp	筵
ttl	丿
ttll	丿
ttlx	篦
ttn	笫
ttnt	秭
ttnt	笫
ttny	夂
ttt	禾
ttth	彳
tttt	禾
tu	冬
tu	科
tua	艨
tuae	艨
tuag	舡
tub	艋
tubl	艋
tue	箭
tuec	艘
tuej	箭
tuf	笠
tufh	科
tufk	乎
tug	艚
tugj	艚
tuh	徉
tuhn	舻
tui	舟
tuie	艄
tuj	简
tujf	箪
tujf	简
tujj	螽
tuk	税
tukh	舯
tukq	税
tul	盘
tulf	盘
tum	舰
tumg	舳
tumh	舢
tumq	舰
tun	艉
tune	艉
tup	舵
tupx	舵
tur	舶
turc	舨
turg	舶
tus	舸
tusg	舾
tusk	舸
tut	艇
tutf	舴
tutp	艇
tuu	艏
tuu	冬
tuuf	艟
tuuh	艏
tuw	船
tuwb	舱
tuwc	般
tuwd	磐
tuwk	船
tux	乘
tuxj	剩
tuxv	乘
tuxx	舭
tuy	航
tuyr	舣
tuyt	舫
tuyw	航
tuyx	舷
tv	委
tv	很
tvd	秉
tvf	委
tvg	律
tvgh	律
tvh	箫
tvhw	箫
tvk	笤
tvkf	笤
tvl	簋
tvlf	簋
tvp	逶
tvpd	逶
tvr	魏
tvrc	魏
tvt	笋
tvtr	笋
tvy	很
tw	答
tw	签
twa	筏
twau	筏
twb	秃
twc	役
twcy	役
twd	颓
twdm	颓
twf	符
twfu	符
twg	徐
twgf	筌
twgg	签
twgk	答
twgs	徐
twgu	簦
twh	筱
twht	筱
twi	黍
twik	黏
twiu	黍
twn	篌
twnd	篌
twy	稚
twyg	稚
twyn	稔
tx	每
tx	繁
txe	篆
txen	胤
txeu	篆
txh	第
txht	第
txi	系
txiu	系
txt	敏
txtg	鳘
txti	繁
txty	後
txty	敏
txu	每
txx	秕
txxf	筚
txxn	秕
txy	毓
txyk	毓
ty	入
ty	篇
tyg	往
tygg	往
tyi	汆
tyi	入
tyiu	汆
tyk	穰
tyke	穰
tym	稿
tymk	篙
tymk	稿
tyn	篇
tyna	篇
tyo	籴
tyou	籴
tyr	篱
tyrc	篱
tyt	彷
tytd	簇
tyv	稂
tyvy	稂
u	产
u	立
ua	并
ua	瓶
uaf	差
uag	疟
uagd	疟
uagy	瓶
uai	冻
uaiy	冻
uaj	瘼
uaj	并
uajd	瘼
uak	阈
uakg	阈
uam	癀
uamw	癀
uap	迸
uape	痨
uapk	迸
uaw	瘩
uawk	瘩
uay	戕
ub	疗
ub	逆
ubd	闻
ubi	疲
ubk	疖
ubk	疗
ubq	瘾
ubqn	瘾
ubt	塑
ubte	朔
ubtf	塑
ubtg	癃
ubtp	逆
ubts	槊
uc	痛
uc	闯
uca	痉
ucad	痉
ucag	羟
uce	衮
ucek	痛
uceu	衮
ucg	冯
ucgd	闯
ucgg	冯
uck	冶
uckg	冶
ucq	兖
ucqb	兖
ucv	疤
ucw	竣
ucwt	羧
ucwt	竣
ucwy	瘫
ucy	瘙
ucyj	瘙
ud	头
ud	郑
udb	郑
udbh	郑
udc	闳
udci	闳
udd	闫
ude	疬
udee	疬
udf	兰
udg	减
udgk	减
udh	痞
udhk	痞
udhn	瘛
udi	头
udj	阉
udjn	阉
udn	疣
udny	疣
udp	送
udpi	闼
udpi	送
udu	关
udw	凑
udwd	凑
udy	状
ue	前
ue	瘦
ueg	疽
uegd	疽
ueh	瘦
uehc	瘦
uej	剪
uejj	前
uejn	翦
uejo	煎
uejv	剪
uek	痈
uekd	痂
uekw	瘸
uep	遂
uepc	阌
uepi	遂
ueq	阋
ueqv	阋
uew	毅
uewc	毅
uewi	瘐
uf	斗
uf	装
ufc	阖
ufcl	阖
ufd	疳
ufdu	奘
uff	闺
uffd	闺
uffi	痔
ufg	壮
ufh	癫
ufhm	癫
ufhw	阗
ufk	斗
ufn	痣
ufnh	闱
ufni	痣
uft	闭
ufte	闭
ufw	凌
ufwt	凌
ufy	装
ufye	装
ug	半
ug	美
ugb	卷
ugbb	卷
ugd	闩
ugd	闰
ugdu	美
uge	靖
ugeg	靖
ugey	瘃
ugg	豢
ugge	豢
ugh	症
ughd	症
ughf	眷
ugj	养
ugjh	判
ugjj	养
ugk	痘
ugk	半
ugkd	痦
ugku	痘
ugl	盖
uglf	盖
ugm	病
ugmw	病
ugn	恙
ugnu	恙
ugo	羹
ugod	痖
ugod	羹
ugou	羔
ugq	冽
ugqe	疠
ugqg	鲞
ugqj	冽
ugr	拳
ugrc	叛
ugrj	拳
ugs	桊
ugsu	桊
ugt	羲
ugty	羲
ugu	羡
uguf	瘗
uguw	羡
ugv	券
ugvf	姜
ugvr	券
ugvv	凄
ugx	痍
ugxg	冱
ugxw	痍
ugy	誊
ugyf	誊
ugyg	癍
uh	着
uh	站
uhd	阒
uhdd	痱
uhdi	阒
uhf	着
uhh	癯
uhhy	癯
uhk	丫
uhkg	站
uhx	疵
uhxv	疵
ui	冰
ui	阔
uii	痧
uiit	痧
uit	阔
uitd	阔
uiw	瘠
uiwe	瘠
uiy	冰
uj	间
uj	单
ujb	鄣
ujbh	鄣
ujd	间
uje	彰
ujet	彰
ujf	音
ujfb	郸
ujfe	冁
ujff	童
ujfj	单
ujg	疸
ujgd	疸
uji	闽
ujj	章
ujjd	阊
ujl	瘟
ujld	瘟
ujn	意
ujnu	意
ujq	竟
ujqb	竟
ujqn	竭
ujqn	羯
ujqu	韵
ujqw	歆
ujt	赣
ujtm	赣
ujtn	戆
ujv	韶
ujvk	韶
uk	问
uk	况
ukb	部
ukbh	部
ukd	问
ukg	瓿
ukgy	瓿
ukh	冲
ukhh	冲
ukj	剖
ukjh	剖
ukk	癌
ukkd	闾
ukkm	癌
ukn	总
uknu	总
ukq	竞
ukqb	兑
ukqb	竞
ukqn	况
ul	闸
ul	曾
uld	痼
uldd	痼
ulg	兽
ulgj	痹
ulgk	兽
ulj	曾
uljf	曾
uljy	甑
ulk	闸
uls	阃
ulsi	阃
ulx	瘰
ulxi	瘰
um	端
um	凋
umd	羰
umdj	端
umdo	羰
umf	凋
umfk	凋
umk	疝
umm	瘿
ummv	瘿
un	闷
un	决
una	癜
unac	癜
unb	阚
unbt	阚
ung	翔
ung	翊
unh	羞
unhc	瘕
unhg	羞
unht	爿
uni	闷
unk	癖
unku	癖
unr	疡
unre	疡
unv	羌
unw	决
unwe	瘳
unwy	决
uo	普
uo	痰
uoj	普
uojf	普
uoo	痰
uooi	痰
uov	瘘
uovd	瘘
uq	次
uq	盗
uqa	阍
uqaj	阍
uqay	羝
uqd	奖
uqdu	奖
uqe	阎
uqed	阎
uqf	将
uqfy	将
uqg	癣
uqgu	癣
uqi	浆
uqiu	浆
uqj	阄
uqjn	阄
uqm	痪
uqmd	痪
uqn	疱
uqnv	疱
uqs	桨
uqsg	酱
uqsu	桨
uqv	净
uqvh	净
uqw	资
uqwk	咨
uqwl	盗
uqwm	资
uqwn	恣
uqwo	粢
uqwv	姿
uqwy	瓷
uqwy	次
uqy	疚
uqyi	疚
uqyl	瘤
ur	交
ur	效
urb	郊
urbh	郊
urc	瓣
urcu	瓣
urt	效
urty	效
uru	交
us	亲
us	辣
usf	瘭
usfi	瘭
usg	尊
usgd	奠
usgd	猷
usgf	酋
usgf	尊
usgp	遵
usgp	遒
usi	闲
usk	疔
uskd	疴
uskg	辣
uskg	竦
uskj	瘌
uskm	癞
usl	阑
usld	阑
usq	鹇
usqg	鹇
usr	新
usrh	新
usu	亲
usw	凇
uswc	凇
ut	道
ut	首
utd	疾
utdi	疾
utdk	痴
ute	颜
ute	产
utee	彦
utem	颜
utf	冼
utfq	冼
uth	首
uthf	痄
uthf	首
uthg	馘
uthp	道
utht	夔
uthx	瘪
utj	痢
utjk	痢
utk	阁
utkd	阁
utn	疙
utnv	疙
utu	疼
utuc	瘢
utui	疼
utv	痿
utvd	痿
uu	立
uu	善
uua	瘥
uuad	瘥
uub	阙
uubw	阙
uuj	阐
uujf	瘅
uujf	阐
uujk	瘴
uujn	癔
uuk	痒
uukb	鄯
uukf	善
uukq	阅
uus	痫
uusi	痫
uuu	立
uuuu	立
uv	妆
uv	兼
uvf	妾
uvg	妆
uvi	痕
uvj	兼
uvjg	鹣
uvjw	歉
uvjw	兼
uw	闪
uw	准
uwa	阀
uwai	阀
uwb	疮
uwbv	疮
uwc	疫
uwci	疫
uwe	疹
uwee	疹
uwf	瘵
uwfi	瘵
uwg	痊
uwgd	阕
uwgd	痊
uwi	闪
uwj	疥
uwjk	疥
uwl	益
uwlf	益
uwlj	蠲
uwn	瘊
uwnd	瘊
uwr	疯
uwri	疯
uwry	飒
uww	痤
uwwf	痤
uwy	冷
uwyc	羚
uwyc	冷
uwyg	准
ux	北
ux	递
uxb	邶
uxbh	邶
uxe	背
uxef	背
uxh	弟
uxhg	鹈
uxhj	剃
uxhp	递
uxht	弟
uxl	冀
uxlw	冀
uxn	北
uxt	凝
uxth	凝
uxu	辫
uxuh	辫
uxx	兹
uxxb	孳
uxxg	鹚
uxxn	慈
uxxu	兹
uy	六
uy	凉
uyg	冫
uygd	疰
uygg	疒
uygh	辛
uygh	丬
uygy	六
uyh	门
uyhn	门
uyi	闵
uyiy	凉
uyl	凛
uyli	凛
uym	闹
uymh	闹
uyn	阂
uynw	阂
uyt	羊
uyth	羊
uytu	辨
uyu	辩
uyuh	辩
uyv	阆
uyvi	阆
uyw	瘁
uywf	瘁
uywu	瘀
uywu	阏
uywv	闶
uyx	痃
uyxi	痃
v	发
v	女
va	既
va	姬
vah	姬
vahh	姬
vaj	嫫
vajd	嫫
vam	媾
vamf	媾
vaq	暨
vaqg	暨
vaqn	既
var	妪
vary	妪
vat	娆
vatq	娆
vb	好
vb	她
vbg	好
vbh	即
vbhj	媸
vbn	她
vbs	婀
vbsk	婀
vbt	奶
vc	妈
vc	始
vcb	孥
vcbf	孥
vcc	驽
vccg	驽
vce	努
vcer	努
vcg	妈
vcgg	妈
vck	始
vckg	始
vcm	帑
vcmh	帑
vcmw	胬
vcn	怒
vcnh	妤
vcnu	怒
vcx	弩
vcxb	弩
vcy	奴
vd	姑
vd	娠
vdf	娠
vdfe	娠
vdg	姑
ve	姐
ve	媛
veg	媛
vegc	媛
vegg	姐
veh	嫂
vehc	嫂
vep	嫒
vepc	嫒
vf	寻
vf	妹
vfc	妓
vfcy	妓
vff	垦
vffg	娃
vfh	奸
vfk	嬉
vfkk	嬉
vfq	妩
vfqn	妩
vfs	媒
vfsh	孀
vfsy	媒
vft	姥
vftx	姥
vfu	嫱
vfu	寻
vfuk	嫱
vfy	妹
vg	建
vg	姨
vga	妍
vgah	妍
vge	婧
vgeg	婧
vgey	婊
vgh	嫣
vgho	嫣
vgk	聿
vgo	娅
vgog	娅
vgp	建
vgpk	建
vgv	婕
vgvh	婕
vgx	姨
vgxw	姨
vh	肃
vh	肀
vhj	肃
vhjw	肃
vhk	肀
vi	录
vi	妙
vii	隶
vij	剥
vijh	剥
vip	逮
viph	嫦
vipi	逯
vipi	逮
vit	妙
vitt	妙
viu	录
vj	旭
vj	巢
vjd	旭
vjf	旮
vjfg	娌
vjg	妲
vjgg	妲
vjj	娼
vjjg	娼
vjl	媪
vjlg	媪
vjs	巢
vjsj	剿
vjsu	巢
vk	如
vk	召
vkb	邵
vkbh	邵
vkc	邕
vkcb	邕
vke	娟
vkeg	娟
vket	劭
vkf	召
vkg	娱
vkg	如
vkgd	娱
vkm	娲
vkmw	娲
vkn	恕
vknu	恕
vkp	迢
vkpd	迢
vkx	絮
vkxi	絮
vl	姻
vl	邋
vld	姻
vldy	姻
vlf	甾
vlr	邋
vlrp	邋
vlx	嫘
vlxi	嫘
vm	姗
vm	妯
vmg	妯
vmgn	娉
vmm	姗
vmmg	姗
vn	恳
vn	刀
vne	娓
vnen	娓
vng	娜
vngb	娜
vngg	彐
vngy	艮
vnh	媚
vnhe	婿
vnhg	妞
vnhg	媚
vnn	妃
vnnn	巛
vnt	刀
vnu	恳
vnx	妮
vnxn	妮
vny	姒
vnyw	姒
vo	灵
vo	嬷
vos	嬷
vosc	嬷
vou	灵
vp	退
vp	嫁
vpg	嫁
vpge	嫁
vpi	退
vpj	婶
vpjh	婶
vpm	帚
vpmh	帚
vpq	婉
vpqb	婉
vpr	嫔
vprw	嫔
vpt	姹
vpta	姹
vpv	巡
vq	婚
vq	姚
vqa	婚
vqaj	婚
vqg	鸠
vqgg	鸠
vqi	姚
vqiy	姚
vqk	娩
vqkq	娩
vqy	妁
vqyy	妁
vr	婢
vrtf	婢
vs	杂
vs	嫩
vsf	嫖
vsfi	嫖
vsk	嫩
vskt	嫩
vsu	杂
vt	九
vt	群
vtd	妖
vtdj	娇
vtdy	妖
vte	尹
vtf	妊
vtfg	妊
vtfy	姝
vtg	姓
vtgg	姓
vth	媳
vthn	媳
vtk	君
vtkb	郡
vtkf	君
vtku	群
vtl	媲
vtlx	媲
vtn	姊
vtn	九
vtnt	姊
vtr	娥
vtry	娥
vu	嫌
vu	娴
vua	姘
vuah	姘
vuj	婵
vujf	婵
vujh	嫜
vur	姣
vury	姣
vus	娴
vusy	娴
vut	嫉
vutd	嫉
vuth	馗
vuv	嫌
vuvw	嫌
vux	娣
vuxt	娣
vv	妇
vv	女
vvg	妇
vvv	女
vvvv	女
vw	妗
vwyn	妗
vx	姆
vx	妣
vxx	妣
vxxn	妣
vxy	姆
vy	妨
vy	忍
vye	妫
vyey	妫
vyi	刃
vyi	丸
vyl	嬗
vylg	嬗
vyn	忍
vynt	妒
vynu	忍
vyp	婷
vyps	婷
vyt	妨
vyu	嫡
vyud	嫡
vyv	娘
vyvy	娘
w	人
w	几
wa	代
wa	袋
wad	偌
wadk	偌
waf	仝
waff	垡
wah	伢
waht	伢
waj	借
wajg	借
wajv	偃
waq	儆
waqj	僭
waqt	儆
war	伛
wary	伛
wat	侥
watq	侥
waw	供
wawy	供
way	伐
waye	袋
wayg	牮
waym	贷
waym	岱
wayo	黛
wayy	代
wb	他
wb	仍
wba	戗
wbay	戗
wbb	仓
wbg	仔
wbg	佴
wbj	创
wbjh	创
wbn	他
wbt	仍
wc	公
wc	仅
wcd	颂
wcdm	颂
wce	俑
wceh	俑
wcg	瓮
wcgy	瓮
wci	凤
wcn	翁
wcnf	翁
wct	俟
wctd	俟
wctg	侔
wcu	殳
wcu	公
wcw	俊
wcwt	俊
wcwy	傩
wcy	仅
wd	估
wd	俺
wda	佐
wdag	佐
wde	侑
wdeg	侑
wdf	侉
wdfn	侉
wdg	仨
wdg	估
wdj	佰
wdjg	佰
wdjn	俺
wdk	佑
wdkg	佑
wdn	优
wdny	优
wds	倚
wdsk	倚
wdt	做
wdtf	俦
wdty	做
wdu	僚
wdui	僚
wdw	傣
wdwg	俸
wdwi	傣
wdy	伏
wdyy	仗
we	佣
we	倪
web	俘
webg	俘
weh	佣
wek	伽
wekg	伽
weq	倪
weqn	倪
wet	仂
wf	什
wf	伟
wfa	偾
wfam	偾
wfc	会
wfcb	郐
wfcj	刽
wfcu	会
wfcy	伎
wfd	儒
wfdj	儒
wff	佳
wffg	佳
wffy	侍
wfg	仁
wfg	仕
wfh	值
wfh	什
wfhg	值
wfi	祭
wfil	畲
wfiu	佘
wfiu	祭
wfk	舍
wfkf	舍
wfkg	佶
wfkh	舒
wfkk	僖
wfn	传
wfnh	伟
wfny	传
wft	佬
wftx	佬
wfv	佞
wfvg	佞
wfy	付
wg	全
wg	合
wgc	倒
wgcf	侄
wgcj	倒
wgd	癸
wgdu	癸
wge	愈
wgee	毹
wgeg	倩
wgej	俞
wgen	愈
wgep	逾
wgeq	觎
wgf	全
wgg	伍
wgi	剑
wgig	佥
wgij	剑
wgit	敛
wgiy	俅
wgj	便
wgjr	便
wgk	使
wgka	龠
wgkb	命
wgkf	合
wgkg	鸽
wgkl	盒
wgkm	颌
wgkn	翕
wgkr	拿
wgkr	使
wgku	登
wgkw	凳
wgkw	歙
wgky	龛
wgl	僵
wglg	僵
wgm	债
wgmw	俩
wgmy	俪
wgmy	债
wgn	兮
wgnb	兮
wgny	佤
wgo	俨
wgot	俨
wgq	例
wgqi	夙
wgqj	例
wgqt	傲
wgs	余
wgsc	叙
wgsf	斜
wgsp	途
wgsu	余
wgu	侠
wgud	侠
wh	个
wh	候
whd	俳
whdd	俳
whf	企
whh	佧
whhy	佧
whj	倬
whj	个
whjh	倬
whm	侦
whmy	侦
whn	候
whnd	候
wht	修
whtd	倏
whte	修
whtn	悠
whty	攸
whw	俱
whwy	俱
why	仆
wi	偿
wi	俏
wie	俏
wieg	俏
wim	倘
wimk	倘
wip	傥
wipc	偿
wipq	傥
wiu	氽
wj	介
wj	但
wjf	俚
wjfg	俚
wjg	但
wjgg	但
wjh	伸
wjhh	伸
wjj	倡
wjj	介
wjjg	倡
wjm	偶
wjmy	偶
wjq	偈
wjqn	偈
wjs	倮
wjsy	倮
wk	保
wk	仲
wkg	俣
wkgd	俣
wkh	促
wkhh	仲
wkhy	促
wkk	侣
wkkg	侣
wkkn	侃
wks	堡
wksf	堡
wkso	煲
wksy	保
wl	佃
wl	偎
wlg	偎
wlg	佃
wlge	儇
wlge	偎
wll	儡
wlll	儡
wm	仙
wm	侧
wmf	倜
wmfk	倜
wmg	侗
wmgk	侗
wmgn	俜
wmh	仙
wmj	侧
wmjh	侧
wmw	催
wmwy	催
wn	亿
wn	似
wnb	倔
wnbm	倔
wnd	倨
wndg	倨
wng	伺
wngk	伺
wnh	假
wnhc	假
wnk	僻
wnku	僻
wnn	亿
wnt	侯
wntd	侯
wnx	伲
wnxn	伲
wny	似
wnyw	似
wo	伙
wo	俯
wov	偻
wovg	偻
wow	俯
wowf	俯
woy	伙
wp	伫
wp	侬
wpe	侬
wpey	侬
wpgg	伫
wpn	倌
wpng	倌
wpr	傧
wprw	傧
wpw	倥
wpwa	倥
wpx	佗
wpxn	佗
wq	你
wq	低
wqa	低
wqay	低
wqb	仰
wqbh	仰
wqd	儋
wqdy	儋
wqi	您
wqin	您
wqiy	佻
wqiy	你
wqk	像
wqke	像
wqkg	佝
wqq	侈
wqqy	侈
wqr	偬
wqrn	偬
wr	风
wr	父
wrb	爷
wrbj	爷
wrc	爸
wrcb	爸
wre	飕
wrec	飕
wrf	釜
wrfu	釜
wrg	伯
wrgd	凰
wrh	飓
wrhw	飓
wri	风
wro	飚
wroo	飚
wrq	爹
wrqc	傀
wrqn	飑
wrqq	爹
wrr	斧
wrrj	斧
wrt	俾
wrtf	俾
wru	父
ws	休
ws	何
wsf	傅
wsfy	傅
wsg	体
wsgg	体
wsh	仃
wsj	剁
wsjh	剁
wsk	何
wskg	何
wso	僳
wsoy	僳
wsq	鸺
wsqg	鸺
wss	傈
wssy	傈
wsu	朵
wsy	休
wt	八
wt	作
wta	伥
wtay	伥
wtc	仫
wtcy	仫
wtd	侨
wtdj	侨
wte	伤
wtet	伤
wtf	任
wtfg	任
wtfh	仵
wtfh	仟
wtfm	赁
wtfn	恁
wtfw	凭
wtfy	侏
wtg	件
wtgh	件
wtgy	佚
wth	亻
wthf	作
wtj	俐
wtjh	俐
wtl	傻
wtlt	傻
wtn	几
wtnn	仡
wtr	俄
wtry	俄
wtu	佟
wtuy	佟
wtv	倭
wtvg	倭
wtx	侮
wtxy	侮
wty	八
wu	们
wu	伴
wuf	伞
wufj	伞
wug	位
wugb	倦
wugh	伴
wuh	佯
wuj	僮
wujf	僮
wuk	倍
wukg	倍
wul	僧
wulj	僧
wun	们
wur	佼
wury	佼
wv	分
wv	健
wvd	颁
wvdm	颁
wvf	坌
wvff	坌
wvg	健
wvgp	健
wvl	盆
wvlf	盆
wvm	贫
wvmj	岔
wvmu	贫
wvn	仇
wvnu	忿
wvp	侵
wvpc	侵
wvr	分
wvt	伊
wvtt	伊
wvy	仞
wvyy	仞
ww	从
ww	欲
wwb	耸
wwbf	耸
wwbn	伧
wwe	俎
wweg	佾
wweg	俎
wwf	坐
wwfc	侩
wwfd	坐
wwfi	傺
wwg	丛
wwgf	丛
wwgg	俭
wwgh	佩
wwgj	偷
wwj	价
wwjh	价
wwk	谷
wwkf	谷
wwkg	鹆
wwkw	欲
wwn	仉
wwnu	怂
wwv	份
wwvt	份
www	众
wwwk	俗
wwwu	众
wwww	人
wwx	伦
wwxn	伦
wwy	伶
wwy	从
wwyc	伶
wwyo	僬
wx	化
wx	华
wxb	仑
wxd	倾
wxdm	倾
wxf	华
wxfj	华
wxj	佛
wxjh	佛
wxm	货
wxmu	货
wxn	化
wxx	偕
wxxn	仳
wxxr	偕
wy	信
wy	住
wyb	隽
wybr	隽
wyc	令
wycb	邻
wycm	领
wycn	翎
wycu	令
wycy	瓴
wye	依
wyey	伪
wyey	依
wyf	储
wyfj	隼
wyfj	储
wyg	隹
wyg	信
wygg	住
wyi	凡
wyiy	僦
wyj	侪
wyjh	侪
wyk	售
wykf	售
wyn	今
wyna	偏
wynb	今
wyne	衾
wynk	含
wynm	贪
wynm	颔
wynn	念
wyo	焦
wyog	鹪
wyoj	劁
wyou	焦
wyp	停
wyps	停
wyr	仪
wyrc	禽
wyry	仪
wys	集
wysu	集
wyt	仿
wyu	傍
wyuy	傍
wyv	食
wyvu	食
wyw	伉
wywn	伉
wyy	雠
wyyy	雠
x	经
x	母
xa	红
xa	练
xad	绒
xadt	绒
xaf	缂
xafh	缂
xag	红
xan	练
xann	绁
xanw	练
xat	绕
xatq	绕
xb	级
xb	弛
xbg	弭
xbm	绌
xbmh	绌
xbn	弛
xbyy	级
xc	弘
xc	缀
xca	弪
xcag	经
xcag	弪
xcc	缀
xccc	缀
xcg	绎
xcgh	绎
xck	绐
xckg	绐
xcn	纾
xcnh	纾
xcy	弘
xd	顷
xd	绑
xdc	绂
xdcy	绂
xdf	绔
xdff	缛
xdfn	绔
xdg	缄
xdgk	缄
xdj	弼
xdjx	弼
xdl	缅
xdlf	缅
xdm	顷
xdmy	顷
xds	绮
xdsk	绮
xdt	绑
xdtb	绑
xdu	缭
xdui	缭
xe	组
xe	幼
xee	绷
xeeg	绷
xeg	缓
xegc	缓
xegg	组
xej	蠡
xejj	蠡
xep	绶
xepc	绶
xet	幼
xeu	彖
xev	绥
xevg	绥
xf	结
xf	续
xfc	纭
xfcy	纭
xfg	绀
xfgg	疆
xfh	缜
xfhw	缜
xfk	缬
xfkg	结
xfkm	缬
xfn	续
xfnd	续
xfnh	纬
xfq	鸨
xfqg	鸨
xft	绪
xftj	绪
xfw	绫
xfwt	绫
xfy	纣
xg	线
xg	纯
xga	线
xgay	线
xgb	纯
xgbn	纯
xgf	纡
xgfh	纡
xgj	绠
xgjr	绠
xgl	缰
xglg	缰
xgm	绩
xgmy	绩
xgo	缙
xgoj	缙
xh	引
xh	绯
xhd	绯
xhdd	绯
xhh	引
xhi	缈
xhit	缈
xhj	绰
xhjh	绰
xi	纱
xi	绡
xid	颍
xidm	颍
xie	绡
xieg	绡
xim	绱
ximk	绱
xit	纱
xitt	纱
xiu	糸
xj	旨
xj	费
xjf	旨
xjg	缇
xjgh	缇
xjh	绅
xjhh	绅
xjk	弗
xjl	缦
xjlc	缦
xjm	费
xjmu	费
xjq	艴
xjqc	艴
xjt	缆
xjtq	缆
xjx	绲
xjxx	绲
xk	强
xk	织
xkb	缉
xkbg	缉
xke	绢
xkeg	绢
xkh	缱
xkhm	缋
xkhp	缱
xkj	绳
xkjg	犟
xkjn	绳
xkjy	强
xkk	缲
xkks	缲
xkw	织
xkwy	织
xl	细
xl	缧
xlg	缳
xlg	细
xlge	缳
xln	缌
xlny	缌
xlx	缧
xlxi	缧
xm	贯
xm	纳
xmf	绸
xmfk	绸
xmm	缨
xmmv	缨
xmr	纲
xmry	纲
xmu	贯
xmw	纳
xmwy	纳
xn	纪
xn	母
xna	缗
xnaj	缗
xng	弓
xngn	弓
xnh	纠
xnhg	纽
xnhh	纠
xnn	幻
xnn	纪
xnng	纟
xnny	母
xnw	缪
xnwe	缪
xo	继
xo	缠
xoj	缠
xojf	缠
xon	继
xonn	继
xot	纩
xov	缕
xovg	缕
xox	粥
xoxa	彝
xoxh	鬻
xoxn	粥
xp	综
xp	缩
xpf	综
xpfi	综
xpg	绽
xpgh	绽
xpn	绾
xpng	绾
xpr	缤
xprw	缤
xpw	缩
xpwj	缩
xq	约
xq	绝
xqa	纸
xqan	纸
xqc	绝
xqcn	绝
xqi	弥
xqiy	弥
xqj	绚
xqjg	绚
xqv	绉
xqvg	绉
xqy	约
xqyy	约
xr	绵
xr	缴
xrc	弧
xrcy	弧
xrm	绵
xrmh	绵
xry	缴
xryt	缴
xs	缚
xs	缃
xsf	缥
xsfi	缥
xsfy	缚
xsh	缃
xshg	缃
xt	乡
xt	张
xta	张
xtay	张
xtb	绣
xtbt	绣
xtd	疑
xtdg	肄
xtdh	疑
xtdm	颖
xtdp	缝
xte	乡
xtf	纤
xtfa	缍
xtfh	纤
xtfm	缵
xtg	绛
xtgh	绛
xtgs	绗
xth	缎
xthc	缎
xthk	绺
xtk	络
xtkg	络
xtn	匕
xtnn	纥
xtnp	缒
xts	绦
xtsy	绦
xtu	终
xtuy	终
xtw	飨
xtwv	飨
xu	弱
xu	弹
xug	绊
xugb	绻
xugh	绊
xuj	弹
xujf	弹
xul	缯
xulj	缯
xur	绞
xury	绞
xuu	缮
xuuk	缮
xuv	缣
xuvw	缣
xuw	缢
xuwl	缢
xux	绨
xuxt	绨
xuxu	弱
xv	绍
xv	绿
xvi	绿
xviy	绿
xvj	缫
xvjs	缫
xvk	绍
xvkg	绍
xvl	缁
xvlg	缁
xvy	纫
xvyy	纨
xvyy	纫
xw	给
xw	维
xwf	绘
xwfc	绘
xwg	缏
xwgk	给
xwgr	缏
xwn	缑
xwnd	缑
xwv	纷
xwvt	纷
xww	纵
xwwy	纵
xwx	纶
xwxn	纶
xwy	维
xwyg	维
xx	比
xx	缘
xxa	畿
xxal	畿
xxe	缘
xxey	缘
xxf	毕
xxfj	毕
xxg	丝
xxgf	丝
xxgg	鸶
xxgx	毙
xxj	绋
xxjh	绋
xxn	毖
xxn	比
xxnt	毖
xxr	皆
xxrf	皆
xxt	彘
xxtx	彘
xxx	纰
xxxn	纰
xxxx	幺
xy	纺
xy	编
xyc	统
xycq	统
xym	缟
xymk	缟
xyn	编
xyna	编
xyr	缡
xyrc	缡
xyt	纺
xyu	缔
xyuh	缔
xyx	弦
xyxy	弦
xyy	纹
y	主
y	言
ya	试
ya	谎
yaa	诫
yaah	诫
yaay	试
yad	诺
yadk	诺
yag	讧
yagg	诓
yah	讶
yaht	讶
yaj	谟
yajd	谟
yak	谨
yakg	谨
yan	谍
yang	讵
yans	谍
yaq	谮
yaqj	谮
yar	讴
yary	讴
yaw	诬
yaww	诬
yay	谎
yayk	谎
yb	享
yb	郭
ybb	郭
ybbh	郭
ybc	诹
ybcy	诹
ybf	享
ybh	邡
ybj	亨
ybm	诎
ybmh	诎
ybo	烹
ybou	烹
ybq	鹑
ybqg	鹑
ybt	敦
ybtn	憝
ybty	敦
ybv	熟
ybvf	塾
ybvo	熟
ybvy	孰
yc	充
yc	弃
yca	弃
ycaj	弃
yce	育
ycef	育
yceh	诵
ycg	译
ycgh	译
yck	诒
yckg	诒
ycn	袤
ycne	袤
ycnk	谲
ycq	充
ycqb	充
yct	诶
yctd	诶
yd	诚
yd	斋
ydg	诂
ydm	斋
ydmj	斋
ydn	诚
ydnn	诚
ydo	诙
ydoy	诙
ydw	谌
ydwn	谌
ye	衣
ye	赢
yee	裒
yeeu	裒
yeg	诅
yegc	谖
yegg	诅
yej	蠃
yejy	蠃
yem	赢
yemk	裔
yemy	赢
yet	谣
yetb	谣
yeu	哀
yeu	衣
yeuy	羸
yev	嬴
yevy	嬴
yew	谀
yewy	谀
yey	为
yeyi	为
yf	计
yf	讲
yff	诗
yffg	诖
yffy	诗
yfh	讦
yfh	计
yfj	讲
yfjh	讲
yfk	诘
yfkg	诘
yfm	谳
yfmd	谳
yfn	读
yfnd	读
yfnh	讳
yfs	谋
yfsy	诔
yfsy	谋
yft	诸
yftj	诸
yfy	讨
yg	证
yg	请
yga	斌
ygay	斌
ygd	主
yge	请
ygeg	请
ygey	诼
ygh	证
yghg	证
ygk	语
ygkg	语
ygu	评
yguf	评
yh	让
yh	卞
yha	谑
yhag	谑
yhd	诽
yhdd	诽
yhg	让
yhu	卞
yhy	讣
yi	就
yi	京
yid	鹫
yidg	鹫
yidy	就
yie	诮
yieg	诮
yip	谠
yipq	谠
yiu	京
yj	刘
yj	剂
yjh	齑
yjh	刘
yjhg	齑
yjj	齐
yjjh	剂
yjl	谩
yjlc	谩
yjq	谒
yjqn	谒
yjs	课
yjse	裹
yjsy	课
yk	训
yk	识
ykf	吝
ykg	误
ykgd	误
ykge	衰
ykh	衷
ykh	训
ykhe	衷
ykhp	谴
ykk	襄
ykke	襄
ykkn	谔
ykky	瓤
ykw	识
ykwy	识
yl	亩
yl	谓
yle	谓
yleg	谓
ylf	亩
ylk	颤
ylki	禀
ylkm	颤
ylw	谡
ylwt	谡
ym	市
ym	高
ymf	调
ymfk	调
ymh	讪
ymhj	市
ymk	高
ymkc	敲
ymkf	高
ymw	讷
ymwy	讷
yn	记
yn	望
ynb	邙
ynbh	邙
ynd	戾
yndi	戾
yne	户
yned	肩
ynef	肓
yneg	望
ynf	讯
ynfh	讯
yng	诩
yngk	词
ynh	盲
ynhd	扉
ynhf	盲
yni	永
ynii	永
ynij	昶
ynk	启
ynkc	扈
ynkd	启
ynm	遍
ynma	扁
ynmk	扃
ynmn	翩
ynmp	遍
ynn	忘
ynn	记
ynna	氓
ynnd	扇
ynnu	忘
ynt	刻
ynte	劾
yntg	肇
ynti	綮
yntj	刻
yntl	谧
yntm	颏
yntw	亥
ynu	戽
ynuf	戽
ynv	亡
ynvf	妄
ynw	雇
ynwe	谬
ynwy	诀
ynwy	雇
yny	房
ynye	房
yo	亦
yo	变
yoa	弈
yoaj	弈
yob	孪
yobf	孪
yoc	变
yocu	变
yod	奕
yodu	奕
yoj	蛮
yoju	蛮
yom	峦
yomj	峦
yomw	脔
yon	恋
yonu	恋
yoo	谈
yooc	燮
yooy	谈
yop	迹
yopi	迹
yopy	谜
yoq	鸾
yoqf	銮
yoqg	鸾
yor	挛
yorj	挛
yos	栾
yosu	栾
you	亦
yov	娈
yovf	娈
yox	弯
yoxb	弯
yp	亮
yp	谊
ype	毫
ypeb	毫
ypeg	谊
ypg	豪
ypge	豪
ypi	这
ypk	膏
ypke	膏
ypl	诨
yplh	诨
yps	亭
ypsj	亭
ypt	诧
ypta	亳
ypta	诧
ypw	亮
ypwb	亮
yq	询
yq	诤
yqa	诋
yqay	诋
yqd	诡
yqdb	诡
yqdy	谵
yqe	谄
yqeg	谄
yqj	询
yqjg	询
yqk	谗
yqku	谗
yqt	诳
yqtg	诳
yqv	诌
yqvg	诌
yqvh	诤
yr	义
yr	离
yrb	离
yrbc	离
yrg	诟
yrgk	诟
yri	义
yrv	亵
yrve	亵
yry	诉
yryy	诉
ys	订
ys	谭
ysh	订
ysj	谭
ysjh	谭
ysk	诃
yskg	诃
ysl	谏
yslg	谏
yt	放
yt	旗
ytb	施
ytbn	施
ytbt	诱
ytd	话
ytdg	话
ytdk	旖
ytdw	旗
yte	旅
ytee	膂
yten	旄
ytey	旅
ytf	许
ytfh	许
ytfk	诰
ytfq	诜
ytfy	诛
ytg	旆
ytgh	旆
yth	诞
ythf	诈
ythp	诞
ytm	谢
ytmf	谢
ytmy	旃
ytn	讫
ytnh	旋
ytnn	讫
ytnx	旎
ytt	族
yttd	族
yttg	旌
ytv	诿
ytvg	诿
ytx	诲
ytxy	诲
yty	州
yty	放
ytyh	州
ytyk	旒
yu	详
yu	帝
yue	谫
yuev	谫
yuh	详
yuj	谙
yujg	谙
yuk	说
yukq	说
yum	商
yumk	商
yuo	谱
yuoj	谱
yup	旁
yuph	帝
yupk	啻
yupy	旁
yuq	谘
yuqk	谘
yus	谰
yusl	斓
yusl	谰
yut	谚
yute	谚
yuv	谦
yuvw	谦
yuw	谥
yuwl	谥
yv	良
yv	郎
yvb	郎
yvbh	郎
yve	朗
yveg	朗
yvi	良
yvk	诏
yvkg	诏
yw	认
yw	论
ywb	亢
ywc	设
ywcy	讼
ywcy	设
ywd	颃
ywdm	颃
ywe	诊
ywet	诊
ywg	谕
ywgg	诠
ywgj	谕
ywk	褒
ywke	褒
ywn	讥
ywr	讽
ywry	讽
ywt	夜
ywty	夜
ywu	於
ywuy	於
yww	卒
ywwf	卒
ywwg	谶
ywx	论
ywxn	讹
ywxn	论
ywy	谁
ywy	认
ywyg	谁
ywyn	谂
ywyo	谯
yx	率
yx	玄
yxi	紊
yxif	率
yxiu	紊
yxj	诣
yxjg	诣
yxl	畜
yxlf	畜
yxt	雍
yxtf	壅
yxtv	饔
yxty	雍
yxu	玄
yxx	谐
yxxr	谐
yy	方
yy	该
yyb	谆
yybg	谆
yyg	亠
yygt	方
yygy	文
yyi	谅
yyiy	谅
yyl	丶
yyll	丶
yyn	讠
yyna	谝
yynw	该
yyr	议
yyry	议
yyt	访
yyu	谤
yyud	谪
yyuh	谛
yyuy	谤
yyw	谇
yywf	谇
yyy	言
yyyy	言
